RequestID,ArrivalTime,DelayTime,FinishTime,InitiatorID,TargetID,IOType,Size,VolumeID,Offset
0,0,847,847,0,0,1,512,8,3248604928
1,1,1954,1955,6,0,1,1536,17,550855197
2,2,212853,212855,5,0,0,57856,25,9533332869
3,3,183635,183638,8,0,0,131072,1,7312112439
4,4,8131,8135,4,0,1,7680,25,4163817643
5,5,9436,9441,3,0,1,2048,21,9037115070
6,6,14261,14267,2,0,1,7680,19,2389392536
7,7,215844,215851,9,0,0,6144,4,3609826299
8,8,96258,96266,1,0,0,5632,5,7196099980
9,9,195203,195212,7,0,0,37888,21,3363457831
10,7030,10463,17493,6,0,1,5120,17,1986415960
11,8470,9689,18159,6,0,1,1024,17,4027531850
12,16460,1275869,1292329,7,0,0,94720,21,5293982871
13,17020,354021,371041,9,0,0,95232,4,3689270032
14,26169,6278,32447,8,0,1,6656,1,2484639786
15,30130,665380,695510,9,0,0,22528,4,1761910648
16,31820,182017,213837,8,0,0,3072,1,5757518326
17,36430,5802,42232,4,0,1,6144,25,8060341985
18,42000,4162,46162,4,0,1,11264,25,3530794542
19,46149,2463952,2510101,3,0,0,51712,21,2666517970
20,54999,6278,61277,6,0,1,6656,17,3303335775
21,61450,336984,398434,5,0,0,57856,25,7825197111
22,62140,10757,72897,6,0,1,17408,17,2948339071
23,64781,8462,73243,7,0,1,512,21,3203991460
24,69220,272782,342002,7,0,0,18432,21,10598285429
25,71040,772122,843162,8,0,0,2048,1,6637545492
26,79310,3645,82955,0,0,1,10240,8,4459391613
27,88210,209610,297820,1,0,0,23040,5,9043613677
28,88390,7891,96281,0,0,1,6656,8,3630423224
29,90449,8405,98854,1,0,1,6656,5,6044007801
30,102440,1004261,1106701,8,0,0,27136,1,2408703057
31,103020,1923564,2026584,7,0,0,76288,21,6410715123
32,104500,579582,684082,9,0,0,17920,4,10010445625
33,105589,854911,960500,3,0,0,72192,21,3128652929
34,107900,1518,109418,6,0,1,1536,17,9288720876
35,108200,902972,1011172,9,0,0,33280,4,5971453112
36,108359,2365,110724,8,0,1,2048,1,6635731902
37,108610,3740,112350,0,0,1,2560,8,10500031351
38,111110,3293941,3405051,9,0,0,33792,4,6698414103
39,111170,687384,798554,9,0,0,101376,4,6257919673
40,112770,260197,372967,9,0,0,6144,4,1739846815
41,115251,3422,118673,7,0,1,3584,21,6608963997
42,117390,2269,119659,4,0,1,1536,25,6242723513
43,117949,3336,121285,1,0,1,2560,5,9217340037
44,118151,6360,124511,7,0,1,5120,21,6760340596
45,118430,2178487,2296917,5,0,0,14848,25,9493613384
46,119180,6099,125279,2,0,1,11776,19,5921984567
47,125380,444636,570016,7,0,0,29696,21,928062183
48,125640,1994,127634,4,0,1,2048,25,9863622102
49,128090,598400,726490,5,0,0,20992,25,2394952292
50,131490,2470,133960,3,0,1,2560,21,9816863800
51,135930,1526765,1662695,1,0,0,19456,5,5839426454
52,138850,44803,183653,0,0,1,7680,8,7034489834
53,139600,759554,899154,1,0,0,19456,5,3092489978
54,140250,72620,212870,0,0,1,2560,8,3826896299
55,140669,73191,213860,1,0,1,41984,5,6477600601
56,141819,1464230,1606049,3,0,0,66560,21,3701498456
57,160780,839341,1000121,7,0,0,71168,21,599740908
58,165180,54117,219297,4,0,1,9728,25,52670847
59,165450,60654,226104,6,0,1,7680,17,3620544242
60,165500,405620,571120,7,0,0,3072,21,2740157698
61,165540,60910,226450,2,0,1,512,19,5634946323
62,167880,2429523,2597403,1,0,0,45056,5,56809302
63,168770,58039,226809,4,0,1,9728,25,2805110179
64,169819,60744,230563,1,0,1,15360,5,10012860043
65,179620,57100,236720,6,0,1,8192,17,8958590234
66,179860,62006,241866,0,0,1,8192,8,7915062107
67,180500,1186482,1366982,7,0,0,17408,21,466081019
68,184880,57972,242852,2,0,1,1536,19,6987894426
69,186589,58209,244798,8,0,1,3072,1,2421737114
70,190030,57674,247704,2,0,1,4608,19,10169149441
71,194581,53469,248050,5,0,1,512,25,2924031
72,196750,51761,248511,0,0,1,10240,8,5641339113
73,204300,48077,252377,4,0,1,6144,25,6305038577
74,209101,43840,252941,7,0,1,10752,21,364542711
75,211500,2878269,3089769,5,0,0,63488,25,646431692
76,214970,971491,1186461,9,0,0,7680,4,399573733
77,215070,818685,1033755,1,0,0,24064,5,10666269624
78,220210,34037,254247,3,0,1,2048,21,6333952360
79,224630,30078,254708,2,0,1,10240,19,1205802367
80,232310,1096429,1328739,9,0,0,75264,4,10073487272
81,234190,567599,801789,8,0,0,7168,1,1880879345
82,234500,20554,255054,0,0,1,512,8,6979290570
83,235221,19987,255208,7,0,1,8704,21,1035348203
84,235670,24044,259714,0,0,1,7168,8,9572914061
85,238450,23210,261660,6,0,1,3072,17,2352641026
86,246900,16066,262966,2,0,1,2048,19,6263024316
87,262780,4374,267154,6,0,1,4608,17,450026362
88,263039,4461,267500,8,0,1,512,1,3654478476
89,268720,4850,273570,4,0,1,5120,25,10286229353
90,275571,1518,277089,7,0,1,1536,21,1744302464
91,279220,3263344,3542564,8,0,0,66048,1,7180202041
92,281951,566,282517,7,0,1,512,21,3723970233
93,288969,8890,297859,6,0,1,12288,17,4298071633
94,291450,7053,298503,2,0,1,512,19,6178328513
95,291610,8953,300563,3,0,1,2560,21,2273727574
96,292830,2268625,2561455,1,0,0,168448,5,9184518521
97,295040,5869,300909,2,0,1,512,19,7278576871
98,295451,7084,302535,7,0,1,2560,21,8213262166
99,296040,745684,1041724,5,0,0,8704,25,10397751160
100,311739,2946,314685,8,0,1,3072,1,217801613
101,317730,643269,960999,5,0,0,1536,25,4538661137
102,318520,1042,319562,4,0,1,1024,25,9127688162
103,319249,4937,324186,6,0,1,12800,17,8107169607
104,324170,2478,326648,6,0,1,2560,17,4007790771
105,330620,2341173,2671793,5,0,0,70144,25,7247004182
106,335090,35974,371064,2,0,1,5120,19,9854246597
107,335240,732553,1067793,8,0,0,3584,1,9313070571
108,339329,40075,379404,8,0,1,6656,1,222702106
109,340720,39030,379750,0,0,1,512,8,3289320149
110,342491,55958,398449,7,0,1,4096,21,3912148130
111,354530,43934,398464,2,0,1,6144,19,6107599259
112,356359,42120,398479,8,0,1,11776,1,1667991498
113,356810,1034792,1391602,8,0,0,78336,1,4082729413
114,360480,38046,398526,4,0,1,6144,25,3703419645
115,361640,3422569,3784209,7,0,0,125440,21,1445502094
116,363081,35460,398541,7,0,1,14848,21,912002141
117,363310,3348071,3711381,0,0,0,86528,8,8405985438
118,366350,32206,398556,4,0,1,512,25,4638776650
119,372071,26500,398571,7,0,1,512,21,1041387877
120,374770,776327,1151097,1,0,0,512,5,2790620604
121,375720,23441,399161,4,0,1,512,25,8245754710
122,384630,15639,400269,4,0,1,1536,25,2977399554
123,388130,2078188,2466318,7,0,0,1024,21,3581936310
124,393470,11075,404545,2,0,1,5632,19,5694943911
125,403990,1541,405531,3,0,1,1536,21,2788839691
126,404580,6488,411068,4,0,1,15872,25,1960546282
127,405259,8715,413974,6,0,1,4608,17,9082143000
128,405460,11740,417200,2,0,1,5120,19,2155502334
129,406880,2192357,2599237,1,0,0,512,5,8611803892
130,411770,8336,420106,4,0,1,4608,25,7234311823
131,413730,677878,1091608,1,0,0,1024,5,8509965154
132,415570,562852,978422,0,0,0,54272,8,6970779547
133,415730,5452,421182,4,0,1,13312,25,1113807359
134,422280,1042,423322,3,0,1,1024,21,7443718082
135,423290,976439,1399729,8,0,0,26624,1,4837169330
136,427600,3475823,3903423,7,0,0,56832,21,437472500
137,428309,1518,429827,6,0,1,1536,17,4438431277
138,430729,2946822,3377551,3,0,0,146432,21,3022585468
139,433239,1994,435233,6,0,1,2048,17,1242642340
140,435350,1518,436868,2,0,1,1536,19,9216473218
141,437280,1042,438322,2,0,1,1024,19,2084445966
142,443401,5326,448727,7,0,1,5632,21,6246117960
143,444350,5770,450120,2,0,1,12800,19,1376917151
144,445130,5976,451106,2,0,1,1536,19,1861875252
145,445830,3412029,3857859,9,0,0,68608,4,2911781283
146,460109,2920468,3380577,3,0,0,3584,21,10137087988
147,463310,1230681,1693991,0,0,0,11264,8,3818958498
148,464820,2470,467290,2,0,1,2560,19,9356619427
149,465240,2972925,3438165,0,0,0,55296,8,9542552591
150,466600,5802,472402,2,0,1,6144,19,2451989099
151,473630,2470,476100,3,0,1,2560,21,9237811436
152,477500,957219,1434719,8,0,0,20992,1,2947800387
153,478921,6286,485207,7,0,1,6656,21,10547229463
154,478970,7543,486513,6,0,1,2048,17,9965249942
155,487250,1518,488768,4,0,1,1536,25,10352413229
156,487681,5023,492704,7,0,1,12800,21,6410332473
157,489780,6794,496574,6,0,1,5120,17,7295493875
158,492920,5600,498520,3,0,1,3072,21,10392810291
159,496240,2626,498866,3,0,1,512,21,9067533033
160,498359,7706,506065,6,0,1,8192,17,1776467003
161,504280,6278,510558,4,0,1,6656,25,8174094359
162,510130,572103,1082233,8,0,0,17408,1,8682859059
163,511720,4850,516570,2,0,1,5120,19,6872314532
164,513879,2801328,3315207,3,0,0,46080,21,1418118157
165,513990,3122865,3636855,5,0,0,197120,25,4957496524
166,517770,482872,1000642,1,0,0,1536,5,585976413
167,518340,2946,521286,4,0,1,3072,25,7917333334
168,537440,6278,543718,4,0,1,6656,25,1434680116
169,545080,3887465,4432545,9,0,0,13312,4,1800361234
170,551860,703055,1254915,0,0,0,22528,8,4225867910
171,556810,975104,1531914,1,0,0,512,5,824772193
172,560420,9611,570031,4,0,1,2560,25,9697488653
173,569990,1433305,2003295,5,0,0,36864,25,6540023712
174,576750,1397614,1974364,9,0,0,31232,4,6282898022
175,579140,864361,1443501,0,0,0,7168,8,1918512365
176,586770,2662223,3248993,0,0,0,34304,8,9988724815
177,589750,1042,590792,4,0,1,1024,25,10252151225
178,595030,1518,596548,3,0,1,1536,21,78446939
179,598210,734670,1332880,9,0,0,13312,4,997561247
180,599060,1135622,1734682,0,0,0,16384,8,5947272857
181,600170,1042,601212,3,0,1,1024,21,1813508630
182,602730,5802,608532,3,0,1,6144,21,1681898875
183,613330,387679,1001009,1,0,0,1024,5,2010287138
184,618840,786920,1405760,7,0,0,7168,21,8275545238
185,623500,2470,625970,4,0,1,2560,25,3368166051
186,623940,3656,627596,4,0,1,2560,25,3550847160
187,631060,1518,632578,4,0,1,1536,25,8626270944
188,639880,2855987,3495867,8,0,0,42496,1,3890882213
189,644620,1725071,2369691,1,0,0,512,5,4292743242
190,650070,1689176,2339246,5,0,0,29184,25,8303857519
191,658331,2470,660801,7,0,1,2560,21,7717511409
192,670850,3616309,4287159,8,0,0,19456,1,5208912652
193,675960,1455724,2131684,5,0,0,4608,25,783146690
194,681950,1212080,1894030,1,0,0,1536,5,9091779799
195,685500,3113856,3799356,9,0,0,49664,4,5255925244
196,687920,2724843,3412763,1,0,0,1024,5,9391150920
197,697660,5326,702986,3,0,1,5632,21,3031140943
198,698450,6482,704932,3,0,1,3072,21,9007480486
199,705270,1446840,2152110,5,0,0,15360,25,4075908180
200,707830,566,708396,4,0,1,512,25,4984936131
201,713130,1364971,2078101,1,0,0,2048,5,3673829204
202,715920,1067842,1783762,1,0,0,1024,5,2420675215
203,730299,3128,733427,8,0,1,9216,1,4110942641
204,730910,1956779,2687689,8,0,0,7680,1,7021959336
205,737790,1311715,2049505,8,0,0,26624,1,4990667553
206,741080,3004449,3745529,7,0,0,512,21,6396044472
207,743860,2897222,3641082,5,0,0,13824,25,10087985804
208,744419,1518,745937,8,0,1,1536,1,4465016943
209,746819,5802,752621,8,0,1,6144,1,6224334140
210,755230,1518,756748,4,0,1,1536,25,8986156618
211,759200,39369,798569,3,0,1,21504,21,1897923955
212,759700,38884,798584,3,0,1,1024,21,4218435246
213,774920,2153001,2927921,5,0,0,71680,25,6040116428
214,781030,3343955,4124985,8,0,0,75264,1,5192655224
215,782820,645488,1428308,7,0,0,512,21,2730706573
216,789420,9839,799259,3,0,1,512,21,1979010187
217,793650,1695908,2489558,1,0,0,1024,5,5972424828
218,795240,3709438,4504678,0,0,0,79360,8,3848264143
219,798850,1667133,2465983,0,0,0,67584,8,6379475760
220,806970,3847437,4654407,1,0,0,2048,5,4652970790
221,813460,6754,820214,3,0,1,7168,21,2560575728
222,813840,3267169,4081009,8,0,0,15872,1,8093508609
223,819450,1666080,2485530,7,0,0,512,21,1213024128
224,825589,4162,829751,8,0,1,11264,1,7658811307
225,829630,3196141,4025771,5,0,0,24576,25,3973227782
226,829900,3898,833798,3,0,1,4096,21,7340027223
227,838420,528905,1367325,1,0,0,1024,5,324128281
228,842160,2820807,3662967,0,0,0,26624,8,6946308568
229,843070,4458,847528,0,0,1,4608,8,1335287307
230,857020,1518,858538,0,0,1,1536,8,4626158539
231,858150,2946,861096,3,0,1,3072,21,336364871
232,859660,1080108,1939768,5,0,0,48128,25,4273161824
233,861040,1216422,2077462,5,0,0,7680,25,9474461050
234,862510,1499087,2361597,7,0,0,1536,21,124019968
235,865050,12308,877358,0,0,1,20480,8,9531123881
236,867470,353904,1221374,1,0,0,512,5,9293001995
237,867820,11126,878946,3,0,1,15872,21,9202120835
238,869220,2283995,3153215,5,0,0,23552,25,4917706049
239,869920,3984573,4854493,0,0,0,93184,8,5884539553
240,870210,9722,879932,3,0,1,1536,21,9154518324
241,874520,1704890,2579410,9,0,0,58880,4,856659045
242,899639,3898,903537,8,0,1,4096,1,10390411083
243,901470,1074187,1975657,1,0,0,1024,5,2387041723
244,904420,5196,909616,0,0,1,13312,8,3667001228
245,906430,3190459,4096889,5,0,0,23040,25,3536960480
246,907150,1068180,1975330,1,0,0,512,5,1496375731
247,911930,13770,925700,0,0,1,26624,8,5183843854
248,912199,14167,926366,8,0,1,1024,1,8974337887
249,914860,810750,1725610,1,0,0,512,5,287181781
250,916479,13113,929592,8,0,1,5120,1,4917619039
251,918760,11818,930578,4,0,1,1536,25,3396668428
252,919301,13223,932524,5,0,1,3072,25,7457333926
253,925880,7515,933395,4,0,1,12288,25,4366457660
254,943290,2216036,3159326,0,0,0,512,8,5778559690
255,946000,54136,1000136,3,0,1,9216,21,7655346743
256,952410,47749,1000159,2,0,1,2560,19,2561058328
257,957030,4375414,5332444,0,0,0,102400,8,6901907343
258,966050,2257335,3223385,5,0,0,10752,25,5621113948
259,968300,3035398,4003698,5,0,0,124416,25,4080853937
260,970350,41823,1012173,3,0,1,1024,21,4511173843
261,972570,2465970,3438540,1,0,0,1024,5,8752642255
262,977390,873115,1850505,7,0,0,2560,21,8466737658
263,978280,314235,1292515,7,0,0,512,21,171384466
264,980540,33849,1014389,4,0,1,3072,25,6430248371
265,1006250,1237136,2243386,1,0,0,512,5,10268782209
266,1009670,24132,1033802,0,0,1,34304,8,9562324716
267,1012239,26173,1038412,8,0,1,7680,1,6939102990
268,1022270,3487774,4510044,5,0,0,15872,25,8299081126
269,1023130,15641,1038771,4,0,1,9728,25,4203710425
270,1026930,692569,1719499,1,0,0,512,5,8631250737
271,1028740,12999,1041739,0,0,1,2560,8,2389640678
272,1029540,14083,1043623,3,0,1,5120,21,6471182681
273,1030500,620599,1651099,0,0,0,5120,8,6279901494
274,1035920,11569,1047489,4,0,1,6144,25,9268529575
275,1036090,3050410,4086500,8,0,0,17920,1,5303082031
276,1036440,2346664,3383104,0,0,0,8192,8,6120882137
277,1042300,5535,1047835,4,0,1,512,25,5695155935
278,1045349,5072,1050421,8,0,1,4096,1,6582483909
279,1050580,693043,1743623,7,0,0,512,21,2696726435
280,1051960,3664955,4716915,9,0,0,158720,4,4791885143
281,1057470,3018353,4075823,0,0,0,104960,8,8536499582
282,1061750,1561253,2623003,7,0,0,1024,21,3051333751
283,1064300,988667,2052967,6,0,0,11264,17,7782189901
284,1066310,2172102,3238412,5,0,0,22016,25,7453142985
285,1066540,2455885,3522425,5,0,0,57344,25,798762846
286,1066900,2403,1069303,4,0,1,1536,25,10020535572
287,1068410,881003,1949413,0,0,0,5632,8,471340077
288,1072940,3140719,4213659,8,0,0,44032,1,7223496466
289,1074640,4312183,5386823,0,0,0,16896,8,10554656269
290,1076739,29985,1106724,1,0,1,45568,5,8850849664
291,1077070,3851893,4928963,9,0,0,95232,4,10443610192
292,1079630,3583380,4663010,0,0,0,28160,8,8575244716
293,1079740,1122275,2202015,5,0,0,46592,25,8146345421
294,1088440,18299,1106739,4,0,1,512,25,9573262667
295,1091130,2593425,3684555,7,0,0,512,21,9893092945
296,1094040,12722,1106762,4,0,1,1536,25,5452293012
297,1094980,3656535,4751515,0,0,0,31744,8,2975652493
298,1097190,2006187,3103377,8,0,0,17408,1,4254741998
299,1100070,2401967,3502037,1,0,0,512,5,2187700058
300,1103209,9352,1112561,1,0,1,6144,5,5000293918
301,1104950,8379,1113329,6,0,1,11776,17,3470859635
302,1116530,4850,1121380,6,0,1,5120,17,4116008129
303,1127100,4162,1131262,4,0,1,11264,25,330586039
304,1127150,14964,1142114,0,0,1,18944,8,6199153285
305,1134580,12360,1146940,0,0,1,7680,8,6510265127
306,1137190,3322093,4459283,0,0,0,23552,8,195502461
307,1152290,7230,1159520,6,0,1,7680,17,5617942120
308,1152350,7836,1160186,4,0,1,1024,25,9354237414
309,1159920,4162,1164082,0,0,1,11264,8,5469361260
310,1160570,4833,1165403,4,0,1,2048,25,10012992570
311,1164890,2561661,3726551,0,0,0,49152,8,9415976747
312,1173150,6278,1179428,0,0,1,6656,8,8356936081
313,1173580,7794,1181374,0,0,1,3072,8,4606410522
314,1180630,3690123,4870753,0,0,0,28672,8,461288835
315,1182810,3178582,4361392,0,0,0,17920,8,3067683094
316,1197190,3348498,4545688,0,0,0,32256,8,1345051609
317,1197300,2892554,4089854,1,0,0,1024,5,9176490200
318,1200130,5326,1205456,2,0,1,5632,19,5935236071
319,1205740,5326,1211066,0,0,1,5632,8,8304528765
320,1210030,1100512,2310542,1,0,0,512,5,1581836651
321,1210840,10241,1221081,2,0,1,16384,19,2879705381
322,1216890,688589,1905479,5,0,0,10240,25,9294060447
323,1219929,3422,1223351,6,0,1,3584,17,2083776019
324,1226130,2725387,3951517,9,0,0,129536,4,9395591263
325,1226260,3324232,4550492,0,0,0,2048,8,3352132894
326,1234830,10757,1245587,2,0,1,17408,19,7071805252
327,1238810,2416030,3654840,5,0,0,44032,25,382524523
328,1253060,2889,1255949,6,0,1,1024,17,280689398
329,1255090,3032240,4287330,7,0,0,512,21,4612728053
330,1261570,30774,1292344,4,0,1,8192,25,6738891401
331,1275230,53540,1328770,4,0,1,34816,25,9685521972
332,1277100,51709,1328809,0,0,1,21504,8,4372562211
333,1293900,1977584,3271484,0,0,0,10240,8,7085839494
334,1296050,2261832,3557882,8,0,0,49152,1,10068734246
335,1314130,2642730,3956860,9,0,0,17408,4,5170956581
336,1315670,17735,1333405,6,0,1,512,17,7490035558
337,1316720,3689761,5006481,7,0,0,512,21,1314896310
338,1330030,8366,1338396,4,0,1,5632,25,9172098935
339,1330380,12202,1342582,6,0,1,6656,17,4270712519
340,1332170,12358,1344528,0,0,1,3072,8,1217061895
341,1333440,11754,1345194,0,0,1,1024,8,7947354646
342,1336779,62981,1399760,1,0,1,66048,5,3773271373
343,1341960,57815,1399775,6,0,1,512,17,9098537001
344,1342400,57390,1399790,2,0,1,1024,19,2285740041
345,1343840,55965,1399805,0,0,1,512,8,8612918635
346,1349610,50210,1399820,4,0,1,8704,25,3978628065
347,1354840,943187,2298027,7,0,0,1536,21,98282492
348,1360630,39205,1399835,6,0,1,2560,17,10434628337
349,1363430,36420,1399850,0,0,1,4608,8,2967556779
350,1372990,233238,1606228,1,0,0,512,5,7539096966
351,1373030,3695515,5068545,0,0,0,35328,8,2908984937
352,1392280,3908941,5301221,8,0,0,95232,1,845747785
353,1400900,4207354,5608254,8,0,0,102400,1,913380617
354,1406330,2470,1408800,0,0,1,2560,8,6635182054
355,1406650,3816659,5223309,8,0,0,145408,1,2715234398
356,1408570,841428,2249998,1,0,0,2048,5,6663363966
357,1423860,1159465,2583325,5,0,0,12800,25,4833474931
358,1430860,1800019,3230879,7,0,0,1024,21,2741286070
359,1436270,505604,1941874,7,0,0,2048,21,3091763990
360,1436690,3043769,4480459,0,0,0,29696,8,9832345389
361,1441140,4374,1445514,2,0,1,4608,19,5884064564
362,1442130,6930,1449060,0,0,1,5632,8,424561019
363,1442510,3665375,5107885,0,0,0,81408,8,6767988380
364,1442829,8817,1451646,8,0,1,4096,1,10048780673
365,1466850,566,1467416,2,0,1,512,19,4205704502
366,1475360,566,1475926,2,0,1,512,19,2357661622
367,1477850,1508355,2986205,0,0,0,20992,8,712772
368,1489970,451217,1941187,5,0,0,4608,25,4764376352
369,1492330,3645,1495975,2,0,1,10240,19,9074075443
370,1501250,2464525,3965775,0,0,0,29184,8,1373978746
371,1504690,1310489,2815179,7,0,0,512,21,6320776169
372,1515401,6754,1522155,5,0,1,7168,25,4974965233
373,1517079,5537,1522616,8,0,1,10240,1,3686807561
374,1529360,1054292,2583652,7,0,0,1024,21,2904715978
375,1534330,3463337,4997667,5,0,0,45056,25,9429225190
376,1535070,1081281,2616351,7,0,0,512,21,5317667306
377,1537080,3353291,4890371,9,0,0,34304,4,4101465258
378,1538360,2191110,3729470,0,0,0,9216,8,3309088141
379,1549810,1868294,3418104,9,0,0,6656,4,9626355314
380,1551460,333461,1884921,0,0,0,3072,8,1789317465
381,1551760,2111690,3663450,7,0,0,1536,21,10352443637
382,1555760,1066908,2622668,0,0,0,13312,8,9705154155
383,1565229,2870,1568099,8,0,1,8704,1,1937209133
384,1572960,2640870,4213830,1,0,0,512,5,4459903499
385,1577930,1512166,3090096,1,0,0,1024,5,9393698162
386,1578240,3918205,5496445,5,0,0,309248,25,3593399236
387,1583270,2772647,4355917,8,0,0,75776,1,10187498210
388,1586480,23894,1610374,4,0,1,11264,25,6769249297
389,1604729,6631,1611360,8,0,1,1536,1,7609055353
390,1606220,10671,1616891,0,0,1,7168,8,6233103392
391,1611380,7137,1618517,2,0,1,2560,19,5790232550
392,1613460,4060407,5673867,0,0,0,60416,8,2123000703
393,1614860,793181,2408041,7,0,0,4096,21,4532869432
394,1615400,1768842,3384242,1,0,0,2560,5,4689314294
395,1616550,1019769,2636319,7,0,0,512,21,3698840309
396,1622610,1920281,3542891,1,0,0,1024,5,8792392995
397,1625760,4162,1629922,0,0,1,11264,8,9640603916
398,1631010,2051799,3682809,8,0,0,63488,1,7869910375
399,1632570,966432,2599002,5,0,0,5120,25,9693745271
400,1633750,1094108,2727858,0,0,0,7168,8,3973179263
401,1636019,2470,1638489,8,0,1,2560,1,6352308903
402,1645400,1603764,3249164,7,0,0,512,21,3506566500
403,1647270,1042,1648312,0,0,1,1024,8,4345535369
404,1647610,1924867,3572477,9,0,0,19968,4,6500334421
405,1649210,6278,1655488,9,0,1,6656,4,5238536908
406,1649510,6132,1655642,9,0,1,8704,4,949418940
407,1655330,7380,1662710,4,0,1,2560,25,1720925012
408,1663210,1716236,3379446,9,0,0,6144,4,3876546756
409,1663270,3312973,4976243,0,0,0,89088,8,9471857523
410,1665810,1794627,3460437,9,0,0,12800,4,683356196
411,1666290,3910562,5576852,1,0,0,512,5,1563677439
412,1666630,2470,1669100,2,0,1,2560,19,8428874093
413,1667940,1828106,3496046,7,0,0,512,21,3143110794
414,1668509,3128,1671637,8,0,1,9216,1,8151961922
415,1671340,3705237,5376577,8,0,0,43520,1,2976000270
416,1674100,1072625,2746725,0,0,0,18944,8,5459559374
417,1678909,566,1679475,8,0,1,512,1,1750501875
418,1680350,1133293,2813643,7,0,0,512,21,3645140194
419,1680670,566,1681236,4,0,1,512,25,4382898172
420,1682299,4682,1686981,8,0,1,12288,1,9179233378
421,1682960,3196856,4879816,0,0,0,29696,8,5484666178
422,1686950,3387,1690337,4,0,1,9728,25,2421649908
423,1691570,6850,1698420,4,0,1,11776,25,1549603496
424,1692900,5866,1698766,4,0,1,512,25,704614718
425,1694670,4762,1699432,2,0,1,1024,19,1530503546
426,1698860,4937,1703797,2,0,1,12800,19,7132565380
427,1704940,3331707,5036647,8,0,0,88064,1,1026785712
428,1707640,2946,1710586,4,0,1,3072,25,8757093261
429,1708030,6422,1714452,4,0,1,6144,25,9666245305
430,1712840,1958,1714798,4,0,1,512,25,9231339893
431,1713380,3364,1716744,2,0,1,3072,19,10727913256
432,1716120,970,1717090,4,0,1,512,25,9418305487
433,1724229,10468,1734697,8,0,1,6656,1,8926170881
434,1726180,8532,1734712,6,0,1,4096,17,5436267776
435,1736740,2470,1739210,6,0,1,2560,17,10178755054
436,1737510,4940762,6678272,9,0,0,34304,4,9263365339
437,1738630,1994,1740624,0,0,1,2048,8,4473829034
438,1740449,3387,1743836,8,0,1,9728,1,10282499420
439,1742070,2435806,4177876,7,0,0,512,21,5571846787
440,1743780,5986,1749766,4,0,1,14848,25,4563795564
441,1757540,7230,1764770,0,0,1,7680,8,1720106170
442,1758270,10046,1768316,2,0,1,5632,19,3911655617
443,1759349,24428,1783777,1,0,1,35840,5,2064051187
444,1765899,23376,1789275,1,0,1,18944,5,134969901
445,1771469,19432,1790901,8,0,1,2560,1,2201091888
446,1778120,2311399,4089519,8,0,0,9728,1,2315582802
447,1779169,3343298,5122467,4,0,0,7680,25,5809669184
448,1781530,2018153,3799683,7,0,0,1024,21,8605200405
449,1783910,4249371,6033281,8,0,0,83456,1,9516285108
450,1784880,7007,1791887,6,0,1,1536,17,1197650958
451,1786110,6033,1792143,4,0,1,9216,25,7312141889
452,1786859,5438,1792297,6,0,1,8704,17,2163685600
453,1788150,2493050,4281200,0,0,0,93184,8,2398328117
454,1789560,185599,1975159,8,0,0,2560,1,1525887763
455,1791990,5802,1797792,4,0,1,6144,25,5265947075
456,1794110,4844626,6638736,5,0,0,124416,25,5150687973
457,1794530,4888,1799418,2,0,1,2560,19,605356556
458,1795300,3334559,5129859,5,0,0,11776,25,6038524505
459,1807770,2562439,4370209,5,0,0,11776,25,6125097276
460,1811710,3902740,5714450,9,0,0,133120,4,9843890087
461,1818760,4304246,6123006,9,0,0,8192,4,4537466656
462,1820790,3904,1824694,2,0,1,10752,19,9879430616
463,1822940,1297782,3120722,1,0,0,512,5,9404104337
464,1825740,2307562,4133302,1,0,0,1536,5,7594051726
465,1826570,4850,1831420,0,0,1,5120,8,6393872627
466,1827909,162386,1990295,1,0,1,262144,5,5605947627
467,1837540,3105346,4942886,5,0,0,45568,25,6932374627
468,1841390,4368355,6209745,9,0,0,138752,4,7582834373
469,1841530,150353,1991883,0,0,1,15872,8,1332340673
470,1841990,4969917,6811907,5,0,0,52224,25,1220240599
471,1846060,1128173,2974233,8,0,0,42496,1,9207632375
472,1846480,156830,2003310,4,0,1,13824,25,6228645466
473,1847640,155685,2003325,0,0,1,5632,8,8822526584
474,1849250,852673,2701923,1,0,0,1024,5,8174744082
475,1850740,175859,2026599,6,0,1,9728,17,712737383
476,1852990,3961475,5814465,5,0,0,31744,25,7818355188
477,1860470,166144,2026614,0,0,1,512,8,10414667958
478,1863111,163526,2026637,7,0,1,2048,21,6751548661
479,1867510,159150,2026660,0,0,1,20480,8,3848413995
480,1874381,152318,2026699,7,0,1,4096,21,9419216236
481,1877850,148864,2026714,9,0,1,512,4,4142098379
482,1879470,5260762,7140232,5,0,0,90112,25,1908288831
483,1880500,2162469,4042969,0,0,0,52736,8,5689703373
484,1888460,138269,2026729,4,0,1,9728,25,8397531833
485,1889320,2126717,4016037,5,0,0,40448,25,4757107109
486,1892870,2656959,4549829,1,0,0,512,5,5965905296
487,1905210,1275176,3180386,1,0,0,4096,5,1663807183
488,1908711,118033,2026744,7,0,1,10752,21,7870491408
489,1910430,116337,2026767,9,0,1,1536,4,1317326900
490,1914700,3140518,5055218,9,0,0,30208,4,6153916338
491,1916481,110301,2026782,7,0,1,4096,21,9346150067
492,1931520,4051389,5982909,0,0,0,4608,8,7367031974
493,1936910,89895,2026805,0,0,1,6144,8,6500958676
494,1940900,85920,2026820,9,0,1,1024,4,6740075000
495,1947010,537764,2484774,1,0,0,3072,5,2255956885
496,1948340,2496962,4445302,0,0,0,12800,8,8601416830
497,1956270,70565,2026835,0,0,1,9216,8,10449721431
498,1974300,3894777,5869077,9,0,0,26112,4,9185464287
499,1977820,3278162,5255982,5,0,0,53248,25,5090198137
500,1979810,2117274,4097084,7,0,0,512,21,2776136565
501,1997551,35638,2033189,7,0,1,6656,21,10503797027
502,2002120,4247661,6249781,0,0,0,29184,8,5798516945
503,2004770,44750,2049520,9,0,1,20992,4,8126236377
504,2006610,1794804,3801414,9,0,0,5632,4,4047203193
505,2006810,2646755,4653565,9,0,0,87552,4,8067169801
506,2008950,1436549,3445499,8,0,0,22528,1,6743893389
507,2013010,3334175,5347185,8,0,0,9216,1,6286639041
508,2016881,36101,2052982,5,0,1,6656,25,10711194956
509,2019130,33875,2053005,0,0,1,4608,8,1465629470
510,2023030,29990,2053020,0,0,1,3584,8,5115652125
511,2027880,1773861,3801741,7,0,0,1024,21,10424513226
512,2030740,1352691,3383431,1,0,0,1024,5,8928825043
513,2032940,1993946,4026886,0,0,0,3584,8,9512985579
514,2034640,18403,2053043,0,0,1,12288,8,4506543306
515,2036080,4196152,6232232,0,0,0,73728,8,4034385778
516,2046890,9253,2056143,0,0,1,9216,8,8281655328
517,2050980,4042419,6093399,0,0,0,196608,8,5968711913
518,2062300,3422,2065722,4,0,1,3584,25,2405606850
519,2062970,2666768,4729738,0,0,0,41984,8,333503809
520,2063590,814511,2878101,9,0,0,1536,4,4828995882
521,2071030,1042,2072072,4,0,1,1024,25,66085342
522,2071980,6152,2078132,0,0,1,5120,8,747817084
523,2075780,2229516,4305296,9,0,0,45056,4,6400402761
524,2075930,6867,2082797,9,0,1,12288,4,2581148258
525,2091970,2443859,4535829,8,0,0,57344,1,2367310057
526,2099340,3030698,5130038,7,0,0,512,21,1698829134
527,2104860,3689749,5794609,5,0,0,58368,25,8191925365
528,2107000,3451134,5558134,5,0,0,145920,25,8368715162
529,2109580,5254141,7363721,0,0,0,32768,8,8229853490
530,2112740,566,2113306,9,0,1,512,4,7447056097
531,2113820,3422,2117242,0,0,1,3584,8,9228459055
532,2121770,2470,2124240,0,0,1,2560,8,9233022460
533,2125060,667663,2792723,9,0,0,7168,4,4416173904
534,2126930,3449743,5576673,9,0,0,5632,4,10233503572
535,2127270,6488,2133758,0,0,1,15872,8,9510297816
536,2132010,3054,2135064,9,0,1,2048,4,5769791806
537,2135500,566,2136066,0,0,1,512,8,4578621757
538,2137830,3128,2140958,9,0,1,9216,4,1231363818
539,2140300,6875,2147175,9,0,1,15872,4,4103672382
540,2151550,3022,2154572,0,0,1,2560,8,10413623482
541,2171120,566,2171686,9,0,1,512,4,7951899434
542,2184740,1994,2186734,0,0,1,2048,8,3152695223
543,2187510,1724508,3912018,0,0,0,28160,8,7332361101
544,2189790,2852644,5042434,0,0,0,18944,8,10196251006
545,2193110,14791,2207901,9,0,1,6144,4,10386092624
546,2195680,2365870,4561550,0,0,0,512,8,6804507489
547,2196460,2308725,4505185,5,0,0,1536,25,2536033253
548,2199470,1988028,4187498,8,0,0,22528,1,5684537652
549,2203250,9477,2212727,9,0,1,7680,4,8394938697
550,2203630,3367787,5571417,5,0,0,43520,25,770239239
551,2206570,4288056,6494626,9,0,0,47616,4,7259593883
552,2215290,5326,2220616,0,0,1,5632,8,2564255257
553,2222560,4850,2227410,0,0,1,5120,8,9770183000
554,2235610,6278,2241888,9,0,1,6656,4,7252005511
555,2245310,2082900,4328210,9,0,0,43520,4,5451447050
556,2269780,3586858,5856638,5,0,0,37376,25,4218831534
557,2274620,1436940,3711560,7,0,0,512,21,712544820
558,2283340,884290,3167630,7,0,0,2560,21,4898634442
559,2293770,4119122,6412892,8,0,0,6656,1,8219363332
560,2302270,3650016,5952286,5,0,0,34816,25,1884069693
561,2312530,2513540,4826070,9,0,0,29184,4,6797756023
562,2314670,1042,2315712,2,0,1,1024,19,3401464499
563,2314790,2235,2317025,2,0,1,2048,19,246120079
564,2341430,10757,2352187,2,0,1,17408,19,9633857102
565,2341740,3282029,5623769,5,0,0,50688,25,8629489443
566,2342100,1387557,3729657,7,0,0,512,21,6562928176
567,2343670,1214539,3558209,0,0,0,1024,8,8663024316
568,2349900,1957342,4307242,7,0,0,512,21,8885266818
569,2354570,3384403,5738973,8,0,0,80384,1,5539624867
570,2363800,2148451,4512251,5,0,0,7168,25,4975169388
571,2365460,1652776,4018236,9,0,0,7168,4,7166436650
572,2371890,3404912,5776802,5,0,0,62464,25,5198014796
573,2395870,2860447,5256317,0,0,0,1024,8,1766521280
574,2416390,2946,2419336,2,0,1,3072,19,3249771929
575,2427150,2324576,4751726,0,0,0,512,8,607443447
576,2434230,1641928,4076158,0,0,0,1024,8,952952622
577,2447610,3910457,6358067,5,0,0,120832,25,938220999
578,2467040,3474615,5941655,5,0,0,102400,25,6297657898
579,2475760,2468100,4943860,7,0,0,512,21,5044071776
580,2492081,18035,2510116,5,0,1,5120,25,5472835450
581,2519810,1165072,3684882,1,0,0,1024,5,4222077068
582,2531970,2647012,5178982,5,0,0,17408,25,6170612616
583,2533680,4951115,7484795,0,0,0,512,8,5065650993
584,2534990,2471312,5006302,9,0,0,28160,4,4215739947
585,2546530,3607830,6154360,5,0,0,39936,25,82921679
586,2549560,3245228,5794788,1,0,0,512,5,10059933859
587,2551580,2030946,4582526,9,0,0,18944,4,4794188609
588,2552070,763308,3315378,9,0,0,512,4,7922456769
589,2556460,5244044,7800504,1,0,0,512,5,7519370283
590,2558860,3436552,5995412,9,0,0,12800,4,8999565485
591,2559330,4041475,6600805,9,0,0,53760,4,9858746786
592,2559850,40087,2599937,2,0,1,512,19,1659784895
593,2565710,2377971,4943681,9,0,0,2560,4,4061052482
594,2567270,1978761,4546031,1,0,0,1024,5,2325989908
595,2584120,4000282,6584402,9,0,0,56832,4,5289881058
596,2586230,3811016,6397246,9,0,0,128512,4,6946097949
597,2587760,2454845,5042605,7,0,0,512,21,8303295641
598,2587940,2388942,4976882,7,0,0,2048,21,5462302087
599,2594660,3841663,6436323,9,0,0,76800,4,4862383180
600,2599830,4106506,6706336,5,0,0,40960,25,7869323700
601,2608130,4374,2612504,2,0,1,4608,19,9234247180
602,2609750,2433074,5042824,7,0,0,512,21,9933278616
603,2610140,2131672,4741812,9,0,0,19456,4,3795073293
604,2616810,2046559,4663369,7,0,0,1024,21,7896284893
605,2618460,2006480,4624940,8,0,0,15872,1,10348043628
606,2620950,2032810,4653760,7,0,0,512,21,6649991157
607,2625200,1518,2626718,2,0,1,1536,19,4328520530
608,2626440,3371840,5998280,0,0,0,2048,8,267222213
609,2645800,2470,2648270,2,0,1,2560,19,7095426033
610,2646310,283342,2929652,8,0,0,5632,1,7552341703
611,2646850,2469871,5116721,1,0,0,6144,5,6469434580
612,2650980,21939,2672919,2,0,1,1024,19,3665977153
613,2653290,20295,2673585,9,0,1,1024,4,4343616878
614,2658390,3879236,6537626,0,0,0,2048,8,4787997918
615,2662620,2909140,5571760,1,0,0,1024,5,3852368209
616,2671019,4113725,6784744,1,0,1,51712,5,6476727539
617,2674470,2973712,5648182,8,0,0,73216,1,8846678054
618,2677210,4641343,7318553,2,0,1,512,19,5456889364
619,2682460,4636116,7318576,2,0,1,4096,19,9172649279
620,2683290,4778401,7461691,0,0,1,7680,8,317295904
621,2687440,4932242,7619682,2,0,1,1536,19,3043467792
622,2699510,2343493,5043003,1,0,0,512,5,8697907444
623,2703830,4915875,7619705,2,0,1,4608,19,2791825599
624,2705799,5193510,7899309,8,0,1,2048,1,2680631717
625,2710490,4380115,7090605,9,0,0,11776,4,1240288994
626,2711930,5218614,7930544,2,0,1,8192,19,1558138374
627,2713960,1387243,4101203,9,0,0,13312,4,3876386825
628,2720651,5217158,7937809,7,0,1,6656,21,9606033150
629,2723190,2410615,5133805,8,0,0,12288,1,6929287982
630,2734750,5204365,7939115,2,0,1,2048,19,3594108404
631,2734930,5210249,7945179,2,0,1,6656,19,10248039749
632,2737200,418119,3155319,1,0,0,512,5,4253745118
633,2741841,5231492,7973333,7,0,1,1536,21,3088948100
634,2753280,652566,3405846,1,0,0,2560,5,484555527
635,2754250,5219106,7973356,0,0,1,512,8,5316039447
636,2755980,695026,3451006,9,0,0,17920,4,10715890090
637,2756671,5216708,7973379,7,0,1,11264,21,605306954
638,2763670,3770150,6533820,0,0,0,512,8,7430723519
639,2764670,5516815,8281485,8,0,0,79360,1,9799045303
640,2769149,5297653,8066802,8,0,1,512,1,9188714248
641,2775611,5396569,8172180,7,0,1,7680,21,89452058
642,2775790,5471485,8247275,3,0,1,1024,21,8590599458
643,2777140,3890649,6667789,0,0,0,1536,8,6532169486
644,2782440,5279746,8062186,8,0,0,52736,1,2726180292
645,2797729,5483779,8281508,8,0,1,3584,1,7755472410
646,2798890,1936963,4735853,8,0,0,19968,1,3888811558
647,2804849,5947266,8752115,1,0,1,12288,5,4862976049
648,2805560,4006526,6812086,0,0,0,512,8,10320844222
649,2810620,3723021,6533641,0,0,0,59392,8,1093355059
650,2810940,2766091,5577031,7,0,0,512,21,3736265223
651,2813010,3188799,6001809,9,0,0,6144,4,57261477
652,2824180,5457507,8281687,1,0,0,512,5,5343994683
653,2835960,1266046,4102006,8,0,0,2560,1,9695743757
654,2839920,1203860,4043780,8,0,0,2560,1,6372870208
655,2845531,5906607,8752138,7,0,1,1536,21,7401515191
656,2848039,5927436,8775475,1,0,1,25088,5,5730049996
657,2848540,4170395,7018935,0,0,0,65024,8,3878936489
658,2849150,1923697,4772847,0,0,0,7680,8,8402212647
659,2849280,6135743,8985023,0,0,1,2048,8,9509538637
660,2864100,3891244,6755344,8,0,0,30208,1,1956055069
661,2871630,6113595,8985225,0,0,1,4096,8,1711617450
662,2872949,6247166,9120115,1,0,1,30208,5,6931458471
663,2876731,6300227,9176958,5,0,1,13312,25,2278934298
664,2883300,801084,3684384,9,0,0,5120,4,4225229634
665,2893430,2330994,5224424,7,0,0,3584,21,4516370297
666,2895800,2343935,5239735,9,0,0,50176,4,9142288887
667,2896590,6292130,9188720,0,0,1,512,8,9976683558
668,2902279,6286472,9188751,8,0,1,6656,1,927399228
669,2905710,3918567,6824277,0,0,0,39936,8,8864975246
670,2918359,6408292,9326651,8,0,1,512,1,4745058264
671,2931710,2869037,5800747,9,0,0,19456,4,5638225473
672,2932131,6409854,9341985,5,0,1,10752,25,2793916461
673,2934071,6407937,9342008,5,0,1,1024,25,5689749717
674,2938009,6404022,9342031,8,0,1,512,1,2522803619
675,2944700,2312116,5256816,7,0,0,1536,21,2296428664
676,2951500,4012542,6964042,8,0,0,51200,1,7442238194
677,2961130,1825076,4786206,7,0,0,1536,21,8767335382
678,2962819,6441540,9404359,8,0,1,11264,1,10500818702
679,2964020,2540092,5504112,0,0,0,25088,8,915920330
680,2967249,6460504,9427753,8,0,1,3584,1,6859838216
681,2970550,670859,3641409,7,0,0,1024,21,9111295653
682,2973759,6569078,9542837,8,0,1,2048,1,8343943168
683,2974591,6590264,9564855,7,0,1,512,21,2847052418
684,2974769,6869808,9844577,1,0,1,84992,5,2051236602
685,2975110,1574540,4549650,9,0,0,11776,4,9649320473
686,2992270,1760003,4752273,7,0,0,1536,21,5938202077
687,3003079,6841521,9844600,8,0,1,2048,1,5949822101
688,3013340,3553707,6567047,8,0,0,76800,1,6675101234
689,3020589,6830016,9850605,1,0,1,28672,5,9412121251
690,3025999,3116170,6142169,4,0,0,43520,25,133041942
691,3056630,3780639,6837269,9,0,0,26624,4,72003163
692,3065219,7072089,10137308,1,0,1,84480,5,2540684050
693,3067539,7069808,10137347,8,0,1,9728,1,681646928
694,3071809,7065561,10137370,8,0,1,1024,1,10670644681
695,3092959,7044434,10137393,1,0,1,10752,5,9305487295
696,3108100,3343846,6451946,0,0,0,51200,8,2943281175
697,3111650,3582183,6693833,8,0,0,47104,1,4235291633
698,3115359,7022057,10137416,8,0,1,512,1,5228114570
699,3117039,7167286,10284325,1,0,1,103424,5,2759084850
700,3119130,7198689,10317819,0,0,1,1536,8,2347252988
701,3127510,2216844,5344354,9,0,0,17920,4,6523546306
702,3131550,2737706,5869256,7,0,0,512,21,910051484
703,3135810,7188781,10324591,4,0,1,10752,25,7188492563
704,3142440,7182817,10325257,0,0,1,1024,8,3087012515
705,3151670,2959247,6110917,0,0,0,44032,8,8802143135
706,3165539,7361492,10527031,1,0,1,104448,5,6596738492
707,3165840,4431114,7596954,9,0,0,117760,4,8871717859
708,3174969,7353364,10528333,1,0,1,10240,5,8307168880
709,3185169,7343187,10528356,1,0,1,1024,5,8653098348
710,3185370,3555412,6740782,9,0,0,16384,4,1160664920
711,3187950,3993653,7181603,9,0,0,135680,4,8548132843
712,3188640,2809819,5998459,7,0,0,512,21,10505088116
713,3199470,658592,3858062,0,0,0,512,8,118380013
714,3200750,7352363,10553113,0,0,1,6656,8,8455489148
715,3216359,7398365,10614724,1,0,1,38912,5,8262886195
716,3228050,4065637,7293687,7,0,0,512,21,1937864721
717,3234070,7380677,10614747,0,0,1,3072,8,5511109542
718,3245529,7421474,10667003,1,0,1,34304,5,1005403699
719,3245630,3291341,6536971,0,0,0,10240,8,1471266394
720,3247610,4045898,7293508,8,0,0,89088,1,6909167524
721,3294430,2462038,5756468,8,0,0,57344,1,4542425922
722,3295319,7425689,10721008,1,0,1,41984,5,558940303
723,3311130,4144899,7456029,8,0,0,18944,1,10552983499
724,3311760,3549545,6861305,9,0,0,9728,4,6248377924
725,3325880,2924712,6250592,8,0,0,2560,1,708811642
726,3338080,2419659,5757739,0,0,0,4096,8,976861147
727,3341420,7380254,10721674,9,0,1,1024,4,9272001679
728,3342610,2231677,5574287,9,0,0,8192,4,2210090711
729,3345370,7390109,10735479,0,0,1,12288,8,4035489807
730,3346380,7389138,10735518,4,0,1,6144,25,5035668938
731,3348339,7492482,10840821,1,0,1,46592,5,4873740201
732,3353940,3637798,6991738,8,0,0,39424,1,7282752679
733,3354450,7501081,10855531,4,0,1,5632,25,6596748913
734,3363490,7492243,10855733,9,0,1,8704,4,2933466261
735,3367450,7535465,10902915,4,0,1,6144,25,6304175332
736,3369210,7533728,10902938,4,0,1,512,25,4258241228
737,3375630,2601146,5976776,7,0,0,2048,21,5123000787
738,3378530,3832112,7210642,9,0,0,95232,4,5055856625
739,3380890,7522406,10903296,9,0,1,3584,4,3246284274
740,3383540,7529942,10913482,9,0,1,4608,4,7300920171
741,3389170,993678,4382848,7,0,0,512,21,8134921868
742,3396879,7516650,10913529,1,0,1,3584,5,6544851722
743,3412800,7500752,10913552,4,0,1,9728,25,7473620707
744,3416040,7497535,10913575,0,0,1,1536,8,2014671667
745,3418839,7494759,10913598,8,0,1,9728,1,8780606669
746,3419320,7494301,10913621,4,0,1,1024,25,6105574509
747,3419710,7493934,10913644,4,0,1,2048,25,6220900469
748,3420390,3898124,7318514,8,0,0,81408,1,8175512132
749,3420920,7492747,10913667,9,0,1,2560,4,7345774784
750,3421829,7589113,11010942,1,0,1,153600,5,1703262110
751,3423740,2696739,6120479,0,0,0,15872,8,7666855619
752,3429180,7583433,11012613,9,0,1,1024,4,1683927314
753,3431109,7583130,11014239,8,0,1,2560,1,417041936
754,3433309,7582556,11015865,8,0,1,2560,1,9414784987
755,3434910,4959249,8394159,8,0,0,19968,1,836563203
756,3436220,2442601,5878821,0,0,0,7680,8,8335963383
757,3436259,7583472,11019731,8,0,1,6144,1,9557356319
758,3440780,7598360,11039140,0,0,1,2048,8,2434938347
759,3455670,4338346,7794016,0,0,0,68608,8,3278754145
760,3459310,7587377,11046687,9,0,1,22016,4,7876069047
761,3475269,7657255,11132524,1,0,1,62976,5,9520461759
762,3481019,7688716,11169735,8,0,1,1024,1,2959801979
763,3484890,7743787,11228677,0,0,1,32768,8,2459629534
764,3485669,7772613,11258282,8,0,1,3584,1,3321501628
765,3496100,2339158,5835258,8,0,0,16896,1,420170352
766,3507439,7881672,11389111,1,0,1,37888,5,4863509927
767,3510519,7899440,11409959,8,0,1,8192,1,9958568320
768,3511749,8054523,11566272,1,0,1,175616,5,1155325148
769,3514899,8051396,11566295,1,0,1,11776,5,8219011936
770,3517610,3025827,6543437,0,0,0,18944,8,7379913519
771,3527099,8050025,11577124,8,0,1,10240,1,3161181289
772,3534010,1262890,4796900,7,0,0,512,21,10687775848
773,3536820,2087284,5624104,7,0,0,1024,21,7834277110
774,3537059,8092965,11630024,1,0,1,45056,5,2975685710
775,3561490,8073360,11634850,0,0,1,7680,8,4751960125
776,3561750,4117624,7679374,0,0,0,25088,8,4920395252
777,3565260,3526616,7091876,0,0,0,4096,8,4646454184
778,3574410,8065586,11639996,9,0,1,8192,4,7586226108
779,3579259,8239355,11818614,1,0,1,140288,5,6019657070
780,3593350,8225287,11818637,0,0,1,4608,8,4608518531
781,3615940,2624918,6240858,9,0,0,15872,4,6779184973
782,3621470,2878530,6500000,9,0,0,6656,4,2809184410
783,3622450,3056001,6678451,7,0,0,512,21,7248929392
784,3623340,8195320,11818660,0,0,1,4096,8,2195355376
785,3632530,8187580,11820110,9,0,1,18432,4,7520313257
786,3643609,8178312,11821921,1,0,1,20480,5,6081012570
787,3643970,3091797,6735767,9,0,0,72704,4,420264517
788,3648010,8174257,11822267,0,0,1,512,8,9466498514
789,3670059,8185430,11855489,1,0,1,46592,5,6618430666
790,3673050,8187624,11860674,0,0,1,16384,8,3803033467
791,3677260,8190702,11867962,0,0,1,7680,8,5704624846
792,3678990,2836524,6515514,0,0,0,38400,8,10329859150
793,3685789,8232801,11918590,1,0,1,22528,5,5739376763
794,3687070,4139737,7826807,7,0,0,1024,21,5091235066
795,3689050,3930593,7619643,8,0,0,71168,1,258611844
796,3696839,8225362,11922201,1,0,1,512,5,3580103799
797,3700630,8225437,11926067,9,0,1,6144,4,6049860605
798,3703139,1922704,5625843,3,0,0,5632,21,724755263
799,3709569,3523310,7232879,3,0,0,2560,21,9171590583
800,3712850,3846901,7559751,9,0,0,32768,4,4731961201
801,3713490,8212731,11926221,0,0,1,8704,8,5818465039
802,3713900,4144112,7858012,7,0,0,50688,21,6734887624
803,3718510,4292071,8010581,7,0,0,73728,21,3213613990
804,3734810,8192717,11927527,0,0,1,2048,8,2748361865
805,3746260,4621982,8368242,8,0,0,124416,1,10581225438
806,3753099,8177014,11930113,8,0,1,4096,1,867578706
807,3757600,8172667,11930267,9,0,1,8704,4,2123786153
808,3758320,8175493,11933813,9,0,1,5632,4,3599948596
809,3762340,3469229,7231569,7,0,0,68608,21,3828657727
810,3769660,3343093,7112753,9,0,0,17920,4,7994005557
811,3770720,2709375,6480095,0,0,0,43520,8,7520097287
812,3771430,8165609,11937039,0,0,1,5120,8,6544769095
813,3775350,8162995,11938345,0,0,1,2048,8,8199962811
814,3782990,1730661,5513651,9,0,0,31232,4,6497496491
815,3783699,1328265,5111964,3,0,0,13312,21,9060444476
816,3785530,3462127,7247657,8,0,0,5120,1,3473474887
817,3801650,1537221,5338871,9,0,0,20992,4,4360956724
818,3807700,3041916,6849616,8,0,0,40448,1,3003314292
819,3819460,3905921,7725381,0,0,0,35840,8,9691081097
820,3829160,8110158,11939318,9,0,1,12800,4,4544316675
821,3834480,3938609,7773089,0,0,0,148480,8,2800594849
822,3835989,8139380,11975369,6,0,1,13312,17,8125130568
823,3836440,8154338,11990778,9,0,1,14848,4,3489816459
824,3843789,4073334,7917123,3,0,0,38912,21,3327366761
825,3846480,4126822,7973302,7,0,0,14336,21,1953683479
826,3846629,4308180,8154809,3,0,0,25600,21,8396083909
827,3850590,2009659,5860249,7,0,0,11776,21,7147266022
828,3856680,2379319,6235999,8,0,0,12288,1,2196152161
829,3859460,8134224,11993684,9,0,1,4608,4,10677505441
830,3862350,4221233,8083583,8,0,0,9728,1,6060395990
831,3863440,3116263,6979703,0,0,0,29184,8,4737472591
832,3869860,2015898,5885758,8,0,0,18432,1,3002033758
833,3872530,4016281,7888811,0,0,0,75264,8,1919891906
834,3873850,4284258,8158108,0,0,0,10752,8,4397982212
835,3880090,2217388,6097478,8,0,0,13312,1,4177671430
836,3882630,8112360,11994990,0,0,1,2048,8,3799183807
837,3883250,8113366,11996616,0,0,1,2560,8,3424420388
838,3883790,3499125,7382915,9,0,0,49664,4,5526967308
839,3891439,8106483,11997922,6,0,1,2048,17,5630498251
840,3893650,8119677,12013327,6,0,1,2560,17,10229397419
841,3898359,667068,4565427,3,0,0,9728,21,2666722084
842,3899050,8115583,12014633,6,0,1,2048,17,6934505763
843,3901580,8115319,12016899,6,0,1,3584,17,6872283087
844,3904800,8116605,12021405,9,0,1,7168,4,9364431991
845,3912570,8112487,12025057,0,0,1,1024,8,3620439108
846,3915010,4594483,8509493,7,0,0,11776,21,3131288083
847,3918090,4128005,8046095,0,0,0,112640,8,6321675343
848,3924889,3007737,6932626,3,0,0,9216,21,8592165002
849,3929640,8096083,12025723,0,0,1,1024,8,4295537776
850,3935660,8091241,12026901,6,0,1,13824,17,9180050894
851,3937330,4792377,8729707,9,0,0,403456,4,4551165772
852,3938620,4828829,8767449,9,0,0,50176,4,8264236229
853,3944240,3122173,7066413,7,0,0,124416,21,5656895681
854,3959620,8068049,12027669,6,0,1,11776,17,7051924509
855,3962310,8076957,12039267,2,0,1,512,19,1757454514
856,3972940,3476959,7449899,0,0,0,52736,8,672648235
857,3975110,8078149,12053259,2,0,1,1536,19,5751774888
858,3980290,3534047,7514337,9,0,0,51200,4,9479938972
859,3982290,8070992,12053282,9,0,1,512,4,10518597300
860,3983620,8069685,12053305,9,0,1,4608,4,1651374520
861,3992530,8060798,12053328,9,0,1,2048,4,7333661263
862,4009379,8050724,12060103,1,0,1,11776,5,1798922389
863,4012270,8055774,12068044,0,0,1,5632,8,5922227424
864,4015380,4859963,8875343,8,0,0,65024,1,8723358416
865,4020150,8051120,12071270,0,0,1,5120,8,7936807128
866,4021110,8051466,12072576,6,0,1,2048,17,1721005679
867,4022340,2974889,6997229,7,0,0,17920,21,6392248848
868,4024570,8049312,12073882,6,0,1,2048,17,6400743657
869,4028000,3637671,7665671,8,0,0,62976,1,1188805700
870,4038350,8037158,12075508,0,0,1,2560,8,9118917578
871,4048840,8030214,12079054,6,0,1,5632,17,813198545
872,4053010,8031216,12084226,6,0,1,8192,17,2145661841
873,4073940,8014792,12088732,0,0,1,7168,8,5928015275
874,4078320,2588970,6667290,8,0,0,3584,1,10361701377
875,4082540,4406455,8488995,8,0,0,73728,1,1443547018
876,4084279,4345704,8429983,3,0,0,51712,21,7874508242
877,4094510,7999540,12094050,9,0,1,14336,4,2056363885
878,4111790,1463144,5574934,8,0,0,2048,1,1152664924
879,4116439,4816560,8932999,3,0,0,22528,21,5932977399
880,4134700,7960528,12095228,2,0,1,13824,19,8743825536
881,4140200,7957752,12097952,9,0,1,1024,4,3915622382
882,4153760,7944538,12098298,0,0,1,512,8,8968545980
883,4156050,7942504,12098554,0,0,1,9216,8,2795426153
884,4157430,7942110,12099540,9,0,1,1536,4,8213009710
885,4158710,7941176,12099886,0,0,1,512,8,3854033299
886,4159640,7943472,12103112,9,0,1,5120,4,1858422209
887,4163130,7989194,12152324,9,0,1,2048,4,4154178689
888,4175190,4150878,8326068,0,0,0,81408,8,3067103020
889,4178299,1937321,6115620,3,0,0,15360,21,4300809695
890,4178369,1663152,5841521,3,0,0,20480,21,6958995519
891,4187679,4113554,8301233,3,0,0,32256,21,4866489858
892,4202579,7949768,12152347,1,0,1,2048,5,9456585467
893,4205449,2298318,6503767,3,0,0,12288,21,4909851825
894,4207080,3859520,8066600,7,0,0,13824,21,6417484606
895,4225470,7926900,12152370,4,0,1,2560,25,10679466765
896,4226830,3672970,7899800,8,0,0,1536,1,9592595544
897,4242560,2224252,6466812,9,0,0,46080,4,5781907076
898,4247650,3869138,8116788,7,0,0,37888,21,10090091628
899,4253530,7931473,12185003,0,0,1,1536,8,1987068121
900,4253670,3207998,7461668,7,0,0,18432,21,1690806072
901,4269600,4021782,8291382,7,0,0,31744,21,1724885158
902,4282190,2378011,6660201,9,0,0,11264,4,9828912351
903,4283470,3685441,7968911,7,0,0,71168,21,5082620448
904,4300279,3524428,7824707,3,0,0,79360,21,6812653127
905,4301940,2943153,7245093,9,0,0,17408,4,312295815
906,4302220,4274819,8577039,7,0,0,11264,21,7574973161
907,4305909,4469543,8775452,3,0,0,26112,21,7875639278
908,4307580,2402531,6710111,8,0,0,12288,1,992325741
909,4309660,3814639,8124299,0,0,0,24576,8,7224843161
910,4315400,7872509,12187909,3,0,1,4608,21,2342651182
911,4316010,2333825,6649835,8,0,0,36352,1,8657178539
912,4322020,2755188,7077208,8,0,0,3072,1,2747715602
913,4326220,7863955,12190175,3,0,1,3584,21,7849266888
914,4334260,4571393,8905653,7,0,0,67072,21,510876855
915,4335880,7858481,12194361,3,0,1,6656,21,7585974485
916,4336960,7877141,12214101,3,0,1,22016,21,2424841912
917,4348920,7869390,12218310,0,0,1,12800,8,7279320813
918,4351770,7870531,12222301,0,0,1,6656,8,1581968635
919,4359390,4054814,8414204,9,0,0,28672,4,7710739130
920,4360590,7868483,12229073,0,0,1,10752,8,7247619288
921,4363930,4647058,9010988,0,0,0,84480,8,9997858788
922,4379920,7868926,12248846,3,0,1,1536,21,5996899535
923,4381780,4808710,9190490,0,0,0,5632,8,6760955947
924,4385270,7865661,12250931,0,0,1,10752,8,9701656294
925,4387380,2269366,6656746,7,0,0,22528,21,5257242508
926,4412280,1998561,6410841,8,0,0,44544,1,6271039718
927,4419820,7880259,12300079,3,0,1,13312,21,5017943793
928,4420520,7880225,12300745,3,0,1,1024,21,8092595871
929,4422420,7895389,12317809,3,0,1,14336,21,10493040712
930,4438920,7879875,12318795,3,0,1,1536,21,4115035019
931,4441390,7880951,12322341,2,0,1,5632,19,2314266300
932,4444460,2008289,6452749,0,0,0,2560,8,1067565211
933,4445710,7881137,12326847,2,0,1,7168,19,1723280873
934,4446080,7885668,12331748,3,0,1,2560,21,444864479
935,4446709,3958736,8405445,3,0,0,36352,21,352178242
936,4454910,7935221,12390131,0,0,1,7680,8,4525273336
937,4455210,2042723,6497933,0,0,0,10752,8,7322684615
938,4469970,2276139,6746109,7,0,0,17408,21,7223506013
939,4472940,7954872,12427812,0,0,1,14848,8,9037142452
940,4473950,4655602,9129552,0,0,0,29696,8,10534099443
941,4477120,8051047,12528167,2,0,1,4096,19,9406714313
942,4478150,3065764,7543914,7,0,0,9216,21,1740134339
943,4485250,8044543,12529793,3,0,1,2560,21,5796925430
944,4489710,8044269,12533979,0,0,1,6656,8,185874462
945,4491830,8042495,12534325,0,0,1,512,8,9007767467
946,4493180,4587274,9080454,9,0,0,226816,4,6511271783
947,4494590,8041041,12535631,2,0,1,2048,19,8781037935
948,4495460,2744306,7239766,9,0,0,22528,4,5288828536
949,4495489,4078095,8573584,3,0,0,47616,21,1246963831
950,4513120,8030895,12544015,3,0,1,7680,21,6121599625
951,4517380,2256959,6774339,7,0,0,512,21,4462168045
952,4518609,8243184,12761793,1,0,1,156160,5,6715710188
953,4522560,8247161,12769721,0,0,1,1024,8,5208404504
954,4523110,2020506,6543616,7,0,0,512,21,8656487118
955,4524540,3073396,7597936,7,0,0,512,21,6546697000
956,4525620,8244124,12769744,3,0,1,512,21,7831785276
957,4545320,4239538,8784858,0,0,0,30720,8,9543609217
958,4548390,8221377,12769767,0,0,1,5120,8,4683452752
959,4550230,8222329,12772559,2,0,1,6144,19,4953206148
960,4553330,8225144,12778474,3,0,1,1536,21,8162445780
961,4555090,8253752,12808842,2,0,1,11776,19,5832892114
962,4570670,8251689,12822359,0,0,1,3072,8,7647592050
963,4573230,8289516,12862746,3,0,1,512,21,3959972667
964,4573320,4753300,9326620,8,0,0,48128,1,1995921725
965,4577620,2450854,7028474,9,0,0,31232,4,7501530469
966,4584520,3974525,8559045,0,0,0,68096,8,8670065677
967,4589630,2076545,6666175,8,0,0,6656,1,3359928042
968,4590021,8274991,12865012,7,0,1,3584,21,735728917
969,4603429,3925618,8529047,3,0,0,42496,21,3049046111
970,4604071,8261927,12865998,7,0,1,1536,21,2395879497
971,4604740,8262884,12867624,3,0,1,2560,21,5468169524
972,4610800,8259410,12870210,3,0,1,4096,21,1497603859
973,4611950,3068186,7680136,7,0,0,512,21,6410064485
974,4612681,8266504,12879185,7,0,1,32256,21,7894630547
975,4617799,8262052,12879851,8,0,1,1024,1,1135258829
976,4627079,8257598,12884677,8,0,1,7680,1,8297129160
977,4633669,3872197,8505866,3,0,0,55296,21,9214919235
978,4634931,8253612,12888543,7,0,1,6144,21,957112554
979,4636960,4483124,9120084,0,0,0,36352,8,8786061997
980,4648519,3598733,8247252,3,0,0,245248,21,10491628721
981,4655010,8242955,12897965,3,0,1,2048,21,8666124705
982,4655591,8242397,12897988,7,0,1,5632,21,1513443112
983,4666790,4085302,8752092,8,0,0,15360,1,9730497509
984,4668169,8231388,12899557,8,0,1,2560,1,4128795357
985,4669801,2927956,7597757,2,0,0,2560,19,8391863095
986,4674990,8239412,12914402,3,0,1,6656,21,7545070666
987,4677589,4499346,9176935,3,0,0,37376,21,9399966878
988,4690441,8232512,12922953,7,0,1,9216,21,7509063668
989,4690630,4056759,8747389,0,0,0,14336,8,4821815190
990,4697789,8225187,12922976,8,0,1,3584,1,2697099726
991,4700779,8222220,12922999,8,0,1,10240,1,396091777
992,4703351,8219936,12923287,7,0,1,512,21,7224609447
993,4706130,3239026,7945156,8,0,0,7168,1,6150806403
994,4709989,8215884,12925873,8,0,1,4096,1,2059375307
995,4710040,3806028,8516068,9,0,0,21504,4,845141530
996,4710660,3089018,7799678,9,0,0,17408,4,1290284841
997,4711379,8248595,12959974,8,0,1,4608,1,9383541176
998,4721079,8269600,12990679,8,0,1,26112,1,2364877657
999,4730660,2719574,7450234,7,0,0,1024,21,5211337315
1000,4735069,8256276,12991345,8,0,1,1024,1,196478217
1001,4737430,3087488,7824918,7,0,0,512,21,2117928050
1002,4739779,4480421,9220200,3,0,0,96768,21,3387182932
1003,4741340,4558020,9299360,0,0,0,104448,8,8134043235
1004,4741750,8254101,12995851,3,0,1,7168,21,1647693719
1005,4748619,8284450,13033069,8,0,1,15872,1,1904574452
1006,4752850,8303715,13056565,3,0,1,17920,21,10706448209
1007,4754740,3103919,7858659,7,0,0,2048,21,5549712022
1008,4769619,2549292,7318911,3,0,0,1024,21,7068294804
1009,4770610,3090123,7860733,7,0,0,1536,21,7779084308
1010,4771510,4937818,9709328,8,0,0,19456,1,2976397309
1011,4772440,8295535,13067975,3,0,1,9216,21,4965625999
1012,4778500,8290141,13068641,9,0,1,1024,4,341922803
1013,4778870,4063956,8842826,8,0,0,115712,1,8122490188
1014,4779689,4628749,9408438,3,0,0,13312,21,10479243242
1015,4781249,8291898,13073147,8,0,1,7168,1,408863148
1016,4781410,8293043,13074453,9,0,1,2048,4,9110037057
1017,4786130,8290589,13076719,2,0,1,3584,19,3138271373
1018,4786790,3678603,8465393,9,0,0,24064,4,588195247
1019,4789310,8287755,13077065,3,0,1,512,21,8196148866
1020,4790740,3271625,8062365,7,0,0,512,21,3836982662
1021,4800750,8279861,13080611,3,0,1,5632,21,1152760084
1022,4801929,8286684,13088613,8,0,1,2560,1,8683767733
1023,4806740,2260484,7067224,7,0,0,2560,21,1819242548
1024,4814499,2985826,7800325,3,0,0,2048,21,2829624621
1025,4816260,2670884,7487144,7,0,0,512,21,8859894391
1026,4817410,4628194,9445604,9,0,0,11264,4,5998841330
1027,4818489,3924509,8742998,3,0,0,43520,21,5449648713
1028,4824130,8328840,13152970,0,0,1,21504,8,5672622866
1029,4828639,8375267,13203906,1,0,1,28160,5,1636024812
1030,4838670,8365595,13204265,2,0,1,9728,19,308052382
1031,4841190,8367782,13208972,3,0,1,512,21,2627403637
1032,4842740,8367538,13210278,3,0,1,2048,21,7629132536
1033,4843750,8367194,13210944,3,0,1,1024,21,9201294926
1034,4846330,2224817,7071147,0,0,0,12800,8,7945322748
1035,4847620,8364310,13211930,2,0,1,1536,19,6193327493
1036,4848050,8366146,13214196,2,0,1,3584,19,2893729333
1037,4848450,8366412,13214862,9,0,1,1024,4,1513667509
1038,4848770,8366758,13215528,0,0,1,1024,8,10508448589
1039,4857630,8361764,13219394,9,0,1,6144,4,1657745970
1040,4861440,8358620,13220060,3,0,1,1024,21,7282899330
1041,4861449,3212708,8074157,3,0,0,24064,21,1427153033
1042,4866530,8382436,13248966,0,0,1,7680,8,4479573669
1043,4872350,8376639,13248989,0,0,1,7168,8,5104261529
1044,4872960,8376052,13249012,9,0,1,2048,4,6761647005
1045,4873040,8375995,13249035,0,0,1,2560,8,2104643283
1046,4874270,8374788,13249058,3,0,1,3584,21,9658718257
1047,4874690,4101044,8975734,8,0,0,55808,1,958338943
1048,4874850,8374231,13249081,9,0,1,1024,4,10674186360
1049,4876380,8372724,13249104,0,0,1,1536,8,1905666855
1050,4877720,3252382,8130102,0,0,0,18944,8,3870259351
1051,4898050,8351077,13249127,9,0,1,1536,4,6923322338
1052,4901490,3892283,8793773,9,0,0,29184,4,1305572921
1053,4909360,8339790,13249150,0,0,1,6144,8,584741885
1054,4916250,8392153,13308403,9,0,1,14336,4,4359802941
1055,4925449,3959745,8885194,3,0,0,32256,21,10220433733
1056,4936410,8383170,13319580,4,0,1,5120,25,8503492734
1057,4936940,2390296,7327236,8,0,0,13312,1,1569943904
1058,4937460,8384066,13321526,4,0,1,3072,25,9584016444
1059,4951690,8374342,13326032,3,0,1,7168,21,7015059467
1060,4957209,4203456,9160665,3,0,0,52736,21,9168710049
1061,4958720,4026482,8985202,7,0,0,512,21,209152429
1062,4959920,8372564,13332484,4,0,1,10240,25,4134253876
1063,4960040,2272028,7232068,7,0,0,1536,21,2662103653
1064,4964150,1715276,6679426,7,0,0,3072,21,7160974627
1065,4964800,3467242,8432042,0,0,0,6656,8,1568451488
1066,4971580,8364770,13336350,9,0,1,6144,4,10647237366
1067,4976950,8361666,13338616,4,0,1,3584,25,222509605
1068,4979700,8359582,13339282,3,0,1,1024,21,937223555
1069,4980860,2119322,7100182,8,0,0,10240,1,4408418255
1070,4982500,8357128,13339628,3,0,1,512,21,10290478572
1071,4983090,3872418,8855508,8,0,0,40448,1,7813084465
1072,4984080,8360720,13344800,4,0,1,18432,25,9418851174
1073,4991490,3075289,8066779,7,0,0,512,21,677772555
1074,4994929,8352777,13347706,8,0,1,4608,1,4156967728
1075,4995060,2865182,7860242,0,0,0,5120,8,8378179626
1076,4996860,8352792,13349652,0,0,1,3072,8,631452521
1077,5001130,8578389,13579519,9,0,1,23552,4,6808607229
1078,5011560,8567982,13579542,4,0,1,4608,25,4726343611
1079,5013290,8595389,13608679,9,0,1,15872,4,2715984265
1080,5014470,3364176,8378646,9,0,0,11776,4,5788793919
1081,5016050,8596754,13612804,3,0,1,3584,21,5666902464
1082,5017449,8619401,13636850,1,0,1,30720,5,2715616808
1083,5018350,8621406,13639756,4,0,1,4608,25,9238126549
1084,5019100,8637486,13656586,9,0,1,13312,4,7121040648
1085,5023419,8633190,13656609,8,0,1,3072,1,8057469609
1086,5028180,4346072,9374252,8,0,0,39424,1,3856425451
1087,5032380,3918488,8950868,9,0,0,31744,4,9176747969
1088,5034580,8651449,13686029,4,0,1,7680,25,7222866311
1089,5038550,2062747,7101297,8,0,0,3584,1,9624307698
1090,5039889,8656357,13696246,8,0,1,6144,1,3638257382
1091,5043350,8652919,13696269,3,0,1,512,21,5449409331
1092,5045039,8873105,13918144,1,0,1,117248,5,3947251880
1093,5045879,8932291,13978170,8,0,1,3584,1,2138453694
1094,5046730,3559691,8606421,0,0,0,95744,8,9144676104
1095,5051740,2865562,7917302,7,0,0,512,21,1812025781
1096,5052930,8945971,13998901,4,0,1,2560,25,1268725991
1097,5054620,8949107,14003727,4,0,1,7680,25,5758492970
1098,5055090,8949239,14004329,4,0,1,9728,25,993584526
1099,5058299,8956770,14015069,1,0,1,26624,5,9101166616
1100,5061399,8954976,14016375,8,0,1,2048,1,1301816732
1101,5063559,8959562,14023121,8,0,1,16384,1,10697367161
1102,5082099,2817187,7899286,3,0,0,34304,21,1418551808
1103,5082640,1826887,6909527,7,0,0,512,21,252113237
1104,5087160,8975072,14062232,4,0,1,1024,25,6833894675
1105,5096799,3441475,8538274,3,0,0,30208,21,10574327277
1106,5098320,4153562,9251882,9,0,0,16384,4,8827559309
1107,5099290,8964248,14063538,9,0,1,2048,4,1868296825
1108,5100870,8963014,14063884,4,0,1,512,25,7022219020
1109,5102360,1561764,6664124,0,0,0,12800,8,3089289986
1110,5106500,8960610,14067110,3,0,1,5120,21,8347059209
1111,5109990,8958746,14068736,4,0,1,2560,25,612860754
1112,5111020,9001684,14112704,9,0,1,18944,4,10621951241
1113,5111839,3995672,9107511,3,0,0,17920,21,518604366
1114,5113150,4007152,9120302,9,0,0,512,4,712407988
1115,5123009,9082794,14205803,1,0,1,83456,5,5415605766
1116,5123910,9085759,14209669,9,0,1,6144,4,4323340928
1117,5124579,9104280,14228859,1,0,1,18432,5,10605843618
1118,5124680,9135323,14260003,0,0,1,3072,8,1241279387
1119,5130939,9129087,14260026,1,0,1,11776,5,6495909286
1120,5139640,9120804,14260444,3,0,1,3584,21,8737947202
1121,5140650,4050019,9190669,7,0,0,512,21,8632722350
1122,5140709,9196942,14337651,1,0,1,53248,5,8640349089
1123,5141280,9196394,14337674,0,0,1,2560,8,6959609804
1124,5151230,9186467,14337697,4,0,1,1536,25,1416536815
1125,5153910,9183810,14337720,6,0,1,8192,17,5707401176
1126,5154010,3423208,8577218,7,0,0,512,21,9938885890
1127,5154160,4690394,9844554,9,0,0,95232,4,3473939274
1128,5154259,9244282,14398541,1,0,1,28160,5,2376182505
1129,5154330,2475371,7629701,7,0,0,512,21,1645505779
1130,5155030,9293147,14448177,4,0,1,7680,25,7368434681
1131,5160790,9287768,14448558,2,0,1,18432,19,5378166070
1132,5162250,3095032,8257282,0,0,0,32768,8,10189964635
1133,5162910,9285671,14448581,0,0,1,1024,8,1982385206
1134,5164460,9311923,14476383,4,0,1,1024,25,4840923194
1135,5167260,9309481,14476741,0,0,1,3072,8,10653358067
1136,5167320,9343923,14511243,6,0,1,1024,17,2133326410
1137,5176990,9334276,14511266,0,0,1,9216,8,3238571705
1138,5177930,4525431,9703361,0,0,0,144384,8,7548783405
1139,5180450,4065910,9246360,7,0,0,512,21,1828177830
1140,5188300,9322989,14511289,3,0,1,3584,21,2758641273
1141,5191269,4213067,9404336,3,0,0,30720,21,7527144368
1142,5198060,9322331,14520391,0,0,1,19968,8,5371043046
1143,5203470,9316944,14520414,0,0,1,2560,8,6002954218
1144,5203640,9316821,14520461,6,0,1,4096,17,5501637658
1145,5206019,9380925,14586944,1,0,1,65536,5,3079873599
1146,5212360,9432033,14644393,3,0,1,8192,21,2122099276
1147,5212929,9431666,14644595,1,0,1,9728,5,5856733388
1148,5217301,9428142,14645443,7,0,1,2048,21,5718823930
1149,5219520,9426589,14646109,4,0,1,1024,25,3887489532
1150,5219720,9430255,14649975,4,0,1,6144,25,3242341102
1151,5219779,3229321,8449100,3,0,0,7680,21,10161199103
1152,5220460,3945064,9165524,0,0,0,15872,8,4347915353
1153,5222390,9442722,14665112,3,0,1,1536,21,8947329890
1154,5223700,9456523,14680223,0,0,1,5632,8,315910532
1155,5225239,4792468,10017707,3,0,0,30720,21,10722507727
1156,5228190,9452597,14680787,9,0,1,10752,4,2822284245
1157,5228999,9774706,15003705,1,0,1,195072,5,174841998
1158,5236649,3849132,9085781,3,0,0,17408,21,7421071107
1159,5238500,9765228,15003728,0,0,1,1024,8,2927931505
1160,5240840,9762911,15003751,4,0,1,2048,25,27082593
1161,5240860,3225648,8466508,8,0,0,3584,1,397047012
1162,5249720,2217142,7466862,0,0,0,16896,8,1906134491
1163,5250051,9753723,15003774,7,0,1,3584,21,9589833317
1164,5251991,9751806,15003797,7,0,1,7680,21,8266144241
1165,5253350,9757601,15010951,6,0,1,7680,17,7213168091
1166,5256281,9775438,15031719,7,0,1,512,21,8535391968
1167,5260820,9773444,15034264,3,0,1,23552,21,9043218815
1168,5264920,9788376,15053296,4,0,1,3584,25,2140574089
1169,5268770,9785832,15054602,3,0,1,2048,21,10190745184
1170,5272929,9801080,15074009,1,0,1,21504,5,3645248002
1171,5273140,9830406,15103546,3,0,1,16384,21,8338226952
1172,5274920,9829126,15104046,6,0,1,9216,17,9416553483
1173,5277390,9828922,15106312,6,0,1,3584,17,2561762155
1174,5279040,9828898,15107938,4,0,1,2560,25,743109620
1175,5287679,9919788,15207467,1,0,1,91648,5,5418694194
1176,5291390,4103539,9394929,9,0,0,19456,4,7763763382
1177,5298511,9908979,15207490,7,0,1,1024,21,2744855765
1178,5298549,3031762,8330311,3,0,0,13824,21,9890948508
1179,5301170,4636396,9937566,7,0,0,512,21,8599981366
1180,5305600,9901913,15207513,4,0,1,512,25,9071519278
1181,5306190,9901346,15207536,0,0,1,3072,8,6539090454
1182,5313540,9894019,15207559,0,0,1,6656,8,532564047
1183,5327400,9883285,15210685,0,0,1,2048,8,4874617305
1184,5328019,9886151,15214170,1,0,1,12800,5,3329067976
1185,5330769,4544561,9875330,3,0,0,19456,21,3029536281
1186,5332680,9882361,15215041,0,0,1,12288,8,8462614481
1187,5338709,4421005,9759714,3,0,0,10752,21,2772489668
1188,5340549,9881264,15221813,1,0,1,10752,5,9540265457
1189,5341989,9930371,15272360,1,0,1,95232,5,7673157190
1190,5343260,9931211,15274471,4,0,1,3072,25,4162258183
1191,5347340,9940678,15288018,3,0,1,6144,21,5814215195
1192,5356180,9935704,15291884,6,0,1,6144,17,2619504322
1193,5360560,9938403,15298963,9,0,1,23552,4,5606377394
1194,5361980,9937329,15299309,9,0,1,512,4,4287881828
1195,5366810,9933485,15300295,3,0,1,1536,21,902732034
1196,5367390,9935171,15302561,9,0,1,3584,4,6154536117
1197,5368980,3589711,8958691,9,0,0,25600,4,4493444814
1198,5370059,3437488,8807547,3,0,0,22016,21,3898698266
1199,5373180,9929844,15303024,2,0,1,512,19,3881627020
1200,5377560,9927730,15305290,9,0,1,3584,4,3283670959
1201,5378850,9928386,15307236,9,0,1,3072,4,4484850310
1202,5379560,9927932,15307492,0,0,1,9216,8,643867333
1203,5389470,4747807,10137277,8,0,0,52736,1,1550332551
1204,5394000,3532112,8926112,8,0,0,67072,1,8789058973
1205,5397359,4770748,10168107,3,0,0,40448,21,9661914767
1206,5398190,4861714,10259904,9,0,0,20992,4,9123314389
1207,5398309,2019088,7417397,3,0,0,41984,21,6730295524
1208,5398321,9909517,15307838,5,0,1,512,25,3541556743
1209,5401279,9907020,15308299,1,0,1,10240,5,9811941985
1210,5405281,9905604,15310885,7,0,1,4096,21,10589415643
1211,5409680,4116864,9526544,8,0,0,186880,1,9797020005
1212,5412430,3899503,9311933,8,0,0,33280,1,592223834
1213,5415260,2724701,8139961,8,0,0,32256,1,6675307037
1214,5415709,2959310,8375019,3,0,0,11264,21,5929827273
1215,5417540,4568454,9985994,0,0,0,40448,8,2354707903
1216,5417700,2007191,7424891,7,0,0,512,21,10016948011
1217,5422390,9898434,15320824,6,0,1,11776,17,6332509520
1218,5427109,9920121,15347230,1,0,1,4608,5,10478241671
1219,5427800,9926183,15353983,6,0,1,9216,17,2076911271
1220,5435111,9919858,15354969,7,0,1,1536,21,10039177200
1221,5439720,9917515,15357235,3,0,1,3584,21,887472149
1222,5444480,9915981,15360461,6,0,1,5120,17,7015890569
1223,5447489,2923740,8371229,3,0,0,9728,21,5719673194
1224,5456050,9911199,15367249,9,0,1,7168,4,7668841893
1225,5457060,3778630,9235690,9,0,0,9216,4,5534257904
1226,5458090,4663096,10121186,0,0,0,83456,8,5726014187
1227,5458711,9909102,15367813,7,0,1,10752,21,7814315432
1228,5460870,9909529,15370399,0,0,1,4096,8,8854985925
1229,5462720,3783461,9246181,0,0,0,34304,8,8579624046
1230,5464790,9908195,15372985,9,0,1,4096,4,8893375647
1231,5464809,9919815,15384624,1,0,1,21504,5,3345350929
1232,5468100,4540224,10008324,8,0,0,32256,1,5437546208
1233,5470750,9917531,15388281,3,0,1,512,21,9202293653
1234,5476700,3912270,9388970,9,0,0,46080,4,7808038551
1235,5479659,4114392,9594051,3,0,0,10240,21,2561987227
1236,5480540,9908087,15388627,0,0,1,512,8,5487563451
1237,5487569,4055245,9542814,3,0,0,52736,21,8445433312
1238,5491511,9897475,15388986,7,0,1,9728,21,4375980861
1239,5498750,9891862,15390612,6,0,1,2560,17,5162677375
1240,5500140,9891138,15391278,6,0,1,1024,17,6635059786
1241,5501200,9892344,15393544,3,0,1,3584,21,5384452338
1242,5503940,4748999,10252939,8,0,0,44032,1,4237767429
1243,5525241,9873129,15398370,7,0,1,7680,21,10149953699
1244,5526910,9871806,15398716,6,0,1,512,17,8482875005
1245,5529089,3738416,9267505,3,0,0,51200,21,10589528370
1246,5533140,2261211,7794351,9,0,0,1024,4,3820342015
1247,5534200,9865822,15400022,6,0,1,2048,17,3259338419
1248,5541629,9860979,15402608,8,0,1,4096,1,5356946805
1249,5543620,4709849,10253469,7,0,0,512,21,5861170984
1250,5551939,9854855,15406794,8,0,1,6656,1,7745454572
1251,5552680,4808393,10361073,0,0,0,47616,8,420214417
1252,5557699,9852321,15410020,8,0,1,5120,1,5087446952
1253,5558881,9857822,15416703,7,0,1,13824,21,2015454695
1254,5559599,9860010,15419609,1,0,1,4608,5,8646829058
1255,5560260,9874462,15434722,6,0,1,512,17,359621289
1256,5560400,2886329,8446729,8,0,0,48128,1,7735396561
1257,5560520,9875828,15436348,0,0,1,2560,8,9508370526
1258,5560640,3580011,9140651,9,0,0,36352,4,4986906048
1259,5563350,4084733,9648083,8,0,0,27136,1,6508127519
1260,5568820,9870754,15439574,0,0,1,5120,8,6815223264
1261,5569410,3231406,8800816,0,0,0,23040,8,6311421454
1262,5578600,9862280,15440880,9,0,1,2048,4,8351305993
1263,5580920,9861586,15442506,3,0,1,2560,21,8344678227
1264,5584460,3356713,8941173,0,0,0,25088,8,7830429181
1265,5585130,9866638,15451768,9,0,1,5120,4,7281723993
1266,5587379,9864412,15451791,1,0,1,512,5,8545769142
1267,5588669,3644190,9232859,3,0,0,41472,21,7263547075
1268,5590800,4165428,9756228,7,0,0,1536,21,6090003775
1269,5591769,9860045,15451814,8,0,1,512,1,6360749498
1270,5594320,3707255,9301575,9,0,0,7168,4,841563230
1271,5597030,2774534,8371564,1,0,0,1024,5,625552353
1272,5597399,9854773,15452172,1,0,1,4608,5,8465473065
1273,5597870,9855489,15453359,0,0,1,2560,8,5089205481
1274,5598759,9857186,15455945,8,0,1,4096,1,168461220
1275,5599770,9857161,15456931,3,0,1,1536,21,5167783009
1276,5600240,3384760,8985000,8,0,0,29696,1,9077613330
1277,5603760,2790578,8394338,7,0,0,512,21,5773933462
1278,5609049,9849265,15458314,8,0,1,14848,1,9467080859
1279,5610810,9866354,15477164,0,0,1,2560,8,9218586087
1280,5611659,9865576,15477235,1,0,1,512,5,4796577187
1281,5613561,9873524,15487085,7,0,1,11776,21,6812246606
1282,5615100,3573581,9188681,8,0,0,38400,1,8363036182
1283,5624950,2833088,8458038,1,0,0,512,5,3471038577
1284,5625600,9926368,15551968,3,0,1,36352,21,1702911128
1285,5628379,2759673,8388052,3,0,0,30208,21,5515974652
1286,5639890,4419735,10059625,8,0,0,14336,1,2487141846
1287,5639940,9912374,15552314,0,0,1,512,8,9837892134
1288,5639990,4115404,9755394,9,0,0,116224,4,2182191178
1289,5647941,9904719,15552660,7,0,1,512,21,3017303467
1290,5648720,9953845,15602565,3,0,1,64000,21,4058595693
1291,5650781,9965692,15616473,7,0,1,4608,21,7819424813
1292,5652010,4766404,10418414,9,0,0,44544,4,6666284430
1293,5654550,9969889,15624439,0,0,1,4608,8,2190176079
1294,5654780,4872228,10527008,0,0,0,21504,8,4657967325
1295,5658210,4490039,10148249,7,0,0,1024,21,2166725056
1296,5662119,4153396,9815515,3,0,0,66048,21,8533853024
1297,5665309,9961489,15626798,8,0,1,1024,1,9178953301
1298,5668291,9958853,15627144,7,0,1,512,21,2444051416
1299,5673209,4248368,9921577,3,0,0,151552,21,8618347903
1300,5683759,9944691,15628450,8,0,1,2048,1,3489637162
1301,5684620,3880204,9564824,0,0,0,29696,8,10619935878
1302,5687710,2691115,8378825,7,0,0,512,21,10144324669
1303,5688400,3854616,9543016,7,0,0,512,21,2638481693
1304,5688999,3865623,9554622,3,0,0,37376,21,1481595464
1305,5690900,2766959,8457859,8,0,0,28672,1,10561543745
1306,5691599,9940717,15632316,8,0,1,6144,1,3708191281
1307,5693680,9980579,15674259,3,0,1,32768,21,1179502493
1308,5707680,10011822,15719502,0,0,1,5632,8,4391587336
1309,5707930,10058274,15766204,0,0,1,1024,8,128139933
1310,5708440,10057787,15766227,0,0,1,512,8,7312847350
1311,5718560,10055045,15773605,0,0,1,3072,8,7271043139
1312,5725609,10048027,15773636,8,0,1,4096,1,2635979419
1313,5729729,10043930,15773659,8,0,1,1536,1,7075675673
1314,5729730,10043952,15773682,0,0,1,4096,8,1936333367
1315,5733220,10048948,15782168,9,0,1,29184,4,1458853206
1316,5733599,10048608,15782207,8,0,1,4608,1,2114862642
1317,5734080,3925266,9659346,0,0,0,36864,8,5790632437
1318,5743700,2863056,8606756,7,0,0,1024,21,4049146540
1319,5745110,10037120,15782230,3,0,1,15360,21,2307842487
1320,5752420,10101284,15853704,3,0,1,71168,21,5806994374
1321,5758740,4110631,9869371,0,0,0,47104,8,3947822405
1322,5760291,10103888,15864179,7,0,1,13312,21,4125883790
1323,5764729,10101396,15866125,8,0,1,3072,1,2251598177
1324,5765420,3609487,9374907,0,0,0,2048,8,1192144191
1325,5768360,3593857,9362217,0,0,0,12800,8,7465288565
1326,5776860,10107873,15884733,0,0,1,4608,8,3027647079
1327,5784841,10100878,15885719,7,0,1,1536,21,3818579013
1328,5785090,4408998,10194088,0,0,0,44544,8,4762194542
1329,5788400,4683862,10472262,8,0,0,91136,1,565617956
1330,5791949,3310079,9102028,3,0,0,53248,21,5189016398
1331,5803840,10082670,15886510,0,0,1,11776,8,5999659502
1332,5807020,3126470,8933490,7,0,0,1536,21,4752489950
1333,5818510,3192813,9011323,7,0,0,1024,21,7644739305
1334,5819660,3300821,9120481,7,0,0,512,21,7433952786
1335,5827489,3317085,9144574,3,0,0,12800,21,1971621188
1336,5836149,3505813,9341962,3,0,0,50176,21,6134360601
1337,5840150,4241811,10081961,0,0,0,72192,8,3702245997
1338,5868210,3771582,9639792,8,0,0,32768,1,10157649225
1339,5872710,10019753,15892463,0,0,1,1024,8,4271393970
1340,5873250,10020839,15894089,0,0,1,2560,8,4586424865
1341,5877630,10020645,15898275,0,0,1,6656,8,5031300888
1342,5878290,3877447,9755737,7,0,0,1024,21,7516533628
1343,5899050,3718880,9617930,7,0,0,1024,21,6696242155
1344,5905590,3202880,9108470,0,0,0,3072,8,4914877538
1345,5911710,2931451,8843161,7,0,0,1024,21,2485994239
1346,5917710,3625485,9543195,7,0,0,512,21,9038409854
1347,5923460,9975481,15898941,0,0,1,11264,8,3600308719
1348,5932580,9970867,15903447,0,0,1,7168,8,9875588955
1349,5954340,4658762,10613102,8,0,0,84992,1,8409687644
1350,5956800,3401494,9358294,0,0,0,53248,8,8803428856
1351,5957560,3151425,9108985,0,0,0,1536,8,7975396702
1352,5961880,9942553,15904433,0,0,1,1536,8,8779666289
1353,5968740,4187020,10155760,9,0,0,24576,4,2467444405
1354,5969760,3825592,9795352,9,0,0,104448,4,789722583
1355,5987171,9919528,15906699,5,0,1,3584,25,8384503336
1356,5989111,9938754,15927865,5,0,1,19456,25,5180003656
1357,5992620,2983293,8975913,7,0,0,512,21,1558231082
1358,5995191,9939097,15934288,5,0,1,2048,25,775712486
1359,5998410,3757997,9756407,7,0,0,512,21,673393901
1360,5999820,3417549,9417369,9,0,0,29184,4,10523559932
1361,6005801,9939568,15945369,5,0,1,2048,25,7845560265
1362,6007659,3929720,9937379,3,0,0,39424,21,6239172202
1363,6008980,3237887,9246867,7,0,0,1536,21,9572840044
1364,6011500,9933892,15945392,2,0,1,7168,19,3349808467
1365,6012300,4168193,10180493,8,0,0,39424,1,8725708906
1366,6029730,9916495,15946225,2,0,1,14336,19,3022147282
1367,6036020,3382644,9418664,0,0,0,4096,8,9401775757
1368,6038430,3725051,9763481,8,0,0,12288,1,7032156942
1369,6040519,3948306,9988825,3,0,0,9216,21,10478412179
1370,6040879,9914487,15955366,8,0,1,10240,1,868158404
1371,6045980,4157358,10203338,7,0,0,2048,21,2779244946
1372,6051009,9907583,15958592,8,0,1,5120,1,3262776291
1373,6063219,9905745,15968964,8,0,1,7168,1,118507235
1374,6064150,3984218,10048368,7,0,0,512,21,6818002246
1375,6093639,4190663,10284302,3,0,0,13824,21,7804525412
1376,6106080,4560409,10666489,8,0,0,82944,1,1754181205
1377,6107700,3747296,9854996,9,0,0,14336,4,640769014
1378,6139550,4099950,10239500,0,0,0,88064,8,2743441057
1379,6146550,9843478,15990028,2,0,1,5632,19,2049570827
1380,6154120,9854264,16008384,2,0,1,4096,19,4748655788
1381,6156950,3883556,10040506,8,0,0,74752,1,9769182088
1382,6160510,9896829,16057339,2,0,1,8192,19,1958782321
1383,6164150,3931406,10095556,9,0,0,44544,4,7406484173
1384,6166460,9891545,16058005,2,0,1,1024,19,2620015214
1385,6174910,4027781,10202691,8,0,0,28160,1,2699581271
1386,6175379,3967208,10142587,3,0,0,16896,21,1609039805
1387,6179630,9944710,16124340,2,0,1,1536,19,968549466
1388,6189540,3266483,9456023,9,0,0,12800,4,5964629374
1389,6202600,4050690,10253290,7,0,0,1024,21,3415749074
1390,6228400,4051651,10280051,0,0,0,66048,8,1350708107
1391,6235680,3066074,9301754,7,0,0,512,21,9699568339
1392,6240190,4237555,10477745,9,0,0,17920,4,6952365733
1393,6260540,4144279,10404819,0,0,0,7680,8,9615942778
1394,6263300,3949329,10212629,9,0,0,30208,4,7851217603
1395,6269960,9854403,16124363,4,0,1,1024,25,10570415835
1396,6287400,9836986,16124386,4,0,1,4608,25,4912420584
1397,6293950,9830459,16124409,4,0,1,13824,25,3079840146
1398,6296469,9829943,16126412,8,0,1,12288,1,6847642057
1399,6302110,4537877,10839987,0,0,0,208384,8,9369026038
1400,6303040,9826918,16129958,4,0,1,5632,25,1935210630
1401,6315050,3983733,10298783,9,0,0,1024,4,4939416282
1402,6324890,9807974,16132864,4,0,1,4608,25,6821372051
1403,6339830,3808084,10147914,0,0,0,17408,8,21765065
1404,6348600,4166662,10515262,7,0,0,1536,21,4818292156
1405,6369490,3098100,9467590,9,0,0,37888,4,9243357468
1406,6379250,9754600,16133850,4,0,1,1536,25,8491912234
1407,6393030,9741166,16134196,4,0,1,512,25,2075516378
1408,6401540,3154213,9555753,0,0,0,3584,8,9266895565
1409,6413860,4005404,10419264,7,0,0,2048,21,8610927765
1410,6428280,3098443,9526723,7,0,0,512,21,9093861723
1411,6432560,4097699,10530259,0,0,0,6144,8,1469088028
1412,6434430,9700534,16134964,4,0,1,11776,25,1936998466
1413,6436739,9699531,16136270,1,0,1,2048,5,10317245572
1414,6451140,4063623,10514763,0,0,0,26624,8,4084758156
1415,6451330,9687846,16139176,9,0,1,4608,4,39301587
1416,6468239,9671296,16139535,1,0,1,9728,5,7821919397
1417,6469960,3578221,10048181,9,0,0,25088,4,1627670647
1418,6473290,3121661,9594951,7,0,0,512,21,1646543181
1419,6473489,9666392,16139881,1,0,1,512,5,3337701327
1420,6473690,9703662,16177352,4,0,1,7680,25,8440366608
1421,6474601,9715402,16190003,7,0,1,17920,21,3135476766
1422,6485920,3827445,10313365,7,0,0,1536,21,9903570361
1423,6487549,9702800,16190349,1,0,1,512,5,3331889152
1424,6493500,9699071,16192571,4,0,1,2048,25,6220962075
1425,6497520,3885382,10382902,0,0,0,45568,8,9914050553
1426,6502040,9694121,16196161,4,0,1,7168,25,7669201330
1427,6505759,9692348,16198107,1,0,1,3072,5,10079241928
1428,6508330,3891755,10400085,9,0,0,56320,4,2652391873
1429,6525351,9673422,16198773,7,0,1,1024,21,5950198993
1430,6527240,3410661,9937901,7,0,0,1024,21,1867598493
1431,6532191,9670448,16202639,7,0,1,6144,21,4281585414
1432,6532780,3317615,9850395,0,0,0,18944,8,2621679917
1433,6535011,9749601,16284612,7,0,1,3584,21,4535112142
1434,6536911,9748367,16285278,7,0,1,1024,21,4284606194
1435,6539909,9750515,16290424,1,0,1,8192,5,1849026692
1436,6550030,9744260,16294290,4,0,1,6144,25,5155909095
1437,6554969,9749622,16304591,1,0,1,2560,5,4084317096
1438,6564190,4276608,10840798,7,0,0,2560,21,3266891305
1439,6565640,3359704,9925344,9,0,0,12288,4,3088126707
1440,6586111,9719248,16305359,7,0,1,11776,21,3398617340
1441,6594240,3704208,10298448,9,0,0,45056,4,7609745125
1442,6595360,9761071,16356431,4,0,1,3072,25,115550657
1443,6596380,3254194,9850574,7,0,0,512,21,873946148
1444,6603319,9753135,16356454,1,0,1,512,5,1104187261
1445,6609710,3110249,9719959,9,0,0,34816,4,4078828527
1446,6613889,9742588,16356477,1,0,1,8704,5,7753399675
1447,6616681,9739819,16356500,7,0,1,1024,21,483322510
1448,6617830,9738693,16356523,4,0,1,3072,25,4354648740
1449,6618230,3934844,10553074,9,0,0,74752,4,9683690260
1450,6641750,9714796,16356546,4,0,1,1024,25,5435909275
1451,6659491,9697078,16356569,7,0,1,2560,21,4344493806
1452,6659740,3954961,10614701,0,0,0,5120,8,5620208057
1453,6662219,9694373,16356592,1,0,1,2048,5,3930060013
1454,6663900,3431835,10095735,7,0,0,512,21,4569104406
1455,6685510,3733099,10418609,7,0,0,512,21,6858221311
1456,6699629,9664340,16363969,1,0,1,2048,5,433713223
1457,6711590,4006185,10717775,0,0,0,4608,8,5045820209
1458,6720460,9647055,16367515,4,0,1,5632,25,5155671238
1459,6720500,3786128,10506628,0,0,0,94720,8,2388297382
1460,6721141,9661303,16382444,7,0,1,12800,21,4186435285
1461,6725850,9681375,16407225,0,0,1,512,8,2781099887
1462,6731620,9675951,16407571,0,0,1,512,8,1342824332
1463,6732841,9679876,16412717,7,0,1,8192,21,3445888260
1464,6740410,3780023,10520433,9,0,0,16896,4,893825029
1465,6744171,9722650,16466821,7,0,1,12288,21,3299076752
1466,6746770,3306054,10052824,7,0,0,512,21,5073175545
1467,6760451,9712894,16473345,7,0,1,10240,21,8661494928
1468,6762440,9715339,16477779,0,0,1,7168,8,7142185254
1469,6766251,9714754,16481005,7,0,1,5120,21,8753222725
1470,6780060,9950938,16730998,3,0,1,122368,21,533487126
1471,6787981,9943040,16731021,7,0,1,4096,21,2065275265
1472,6796520,10048581,16845101,3,0,1,77824,21,8789460536
1473,6802220,10235413,17037633,3,0,1,99840,21,3698598985
1474,6813840,10233545,17047385,3,0,1,13824,21,5307148491
1475,6816990,3770193,10587183,7,0,0,512,21,3938091265
1476,6817150,3351308,10168458,7,0,0,1024,21,6264604588
1477,6825700,10237878,17063578,3,0,1,10752,21,2750347886
1478,6826929,10237315,17064244,1,0,1,1024,5,4871404169
1479,6827950,10302636,17130586,3,0,1,53760,21,4166861172
1480,6828560,10318989,17147549,6,0,1,4096,17,7548636077
1481,6843280,10306855,17150135,0,0,1,4096,8,1696471052
1482,6857749,10401815,17259564,1,0,1,35328,5,2707077210
1483,6860790,10398797,17259587,6,0,1,512,17,6825133811
1484,6872060,10556739,17428799,3,0,1,82944,21,3680352515
1485,6889810,4023649,10913459,0,0,0,33280,8,1068882214
1486,6899040,10558260,17457300,3,0,1,9728,21,415567282
1487,6901579,10556067,17457646,1,0,1,512,5,2708147137
1488,6901589,10558963,17460552,1,0,1,4608,5,6221980505
1489,6902430,3732513,10634943,7,0,0,2048,21,4719295116
1490,6904470,3811878,10716348,9,0,0,111616,4,5489528318
1491,6913910,10549348,17463258,6,0,1,2560,17,3685464462
1492,6915089,10550315,17465404,8,0,1,5120,1,10168707953
1493,6917350,3669646,10586996,0,0,0,111104,8,3396566718
1494,6918340,3843063,10761403,9,0,0,70656,4,1498174474
1495,6927299,10546150,17473449,1,0,1,512,5,6083250891
1496,6928450,10549280,17477730,0,0,1,14848,8,1896697804
1497,6930570,10675202,17605772,3,0,1,109568,21,1899743871
1498,6944840,10709770,17654610,0,0,1,10752,8,3107956536
1499,6951850,10723176,17675026,6,0,1,3584,17,4931362360
1500,6955189,10724663,17679852,1,0,1,7680,5,4326597732
1501,6956180,10762624,17718804,0,0,1,12288,8,7450497197
1502,6961409,10757418,17718827,1,0,1,12800,5,5404941878
1503,6962800,10756050,17718850,6,0,1,3584,17,2492484204
1504,6970679,10748194,17718873,1,0,1,16384,5,268291006
1505,6972020,3430428,10402448,9,0,0,7680,4,6601347318
1506,6973100,10758304,17731404,6,0,1,3584,17,6279816323
1507,6974539,10757019,17731558,1,0,1,8704,5,596823740
1508,6975210,10756502,17731712,0,0,1,8704,8,1209688555
1509,6977310,10822099,17799409,3,0,1,60928,21,7397005515
1510,6978990,3440453,10419443,7,0,0,512,21,3371070975
1511,6983239,10826141,17809380,1,0,1,512,5,10436312741
1512,6985969,10824077,17810046,1,0,1,1024,5,9525466701
1513,6986670,10824144,17810814,0,0,1,11776,8,2196449309
1514,6994640,3781653,10776293,9,0,0,1024,4,5712991766
1515,6999570,10817350,17816920,9,0,1,20992,4,2759370148
1516,7000060,10821686,17821746,6,0,1,7680,17,1387879468
1517,7000340,10888214,17888554,3,0,1,94208,21,6807121838
1518,7003800,10888646,17892446,9,0,1,6144,4,7173933653
1519,7005080,3897812,10902892,9,0,0,154624,4,5425797107
1520,7005650,10969584,17975234,3,0,1,95232,21,10712193299
1521,7014090,10970382,17984472,6,0,1,2560,17,195855050
1522,7020680,10978297,17998977,6,0,1,3072,17,9766864320
1523,7025020,10981218,18006238,4,0,1,5632,25,7051449380
1524,7026890,10984494,18011384,4,0,1,8192,25,1897882929
1525,7029770,3637210,10666980,7,0,0,1536,21,5158979521
1526,7031370,10982280,18013650,9,0,1,3584,4,6522369312
1527,7040070,3695386,10735456,9,0,0,34816,4,4682327440
1528,7041950,11003446,18045396,3,0,1,30720,21,2784967383
1529,7047150,10999552,18046702,4,0,1,2048,25,10327922687
1530,7048940,3479370,10528310,0,0,0,4096,8,5639003045
1531,7067010,10982278,18049288,4,0,1,4096,25,4510019476
1532,7080620,10969654,18050274,0,0,1,1536,8,4192184515
1533,7085979,10967521,18053500,1,0,1,5120,5,3302007874
1534,7087799,10967007,18054806,1,0,1,2048,5,7975903832
1535,7092850,10965822,18058672,4,0,1,6144,25,1617248147
1536,7096550,10964734,18061284,4,0,1,4096,25,1138524762
1537,7096720,10970056,18066776,3,0,1,17920,21,10700389270
1538,7099270,3756238,10855508,0,0,0,48128,8,4186379888
1539,7110920,11021626,18132546,9,0,1,512,4,1886648478
1540,7115300,3876966,10992266,0,0,0,24576,8,318640254
1541,7117040,11015529,18132569,0,0,1,3584,8,3133223739
1542,7120110,3655840,10775950,0,0,0,47616,8,2726299423
1543,7138220,10994372,18132592,4,0,1,6144,25,10140759501
1544,7144160,3632312,10776472,7,0,0,512,21,6610937507
1545,7144520,10988095,18132615,9,0,1,32768,4,6003407997
1546,7149160,3785029,10934189,0,0,0,54784,8,6631964479
1547,7157070,10975568,18132638,0,0,1,2560,8,6686501592
1548,7159910,10972751,18132661,4,0,1,11776,25,2186467111
1549,7160140,10973704,18133844,3,0,1,15360,21,1702486232
1550,7165440,10978781,18144221,6,0,1,2048,17,9760417694
1551,7175550,3727723,10903273,7,0,0,1024,21,1269774344
1552,7177280,10970487,18147767,6,0,1,5632,17,1458753911
1553,7187680,11012645,18200325,3,0,1,19456,21,5552354628
1554,7189820,3665890,10855710,7,0,0,512,21,4265680922
1555,7210440,11017923,18228363,6,0,1,5120,17,2799782434
1556,7213360,11015026,18228386,6,0,1,512,17,9337856208
1557,7217480,11010929,18228409,0,0,1,1024,8,4481801058
1558,7221340,11009299,18230639,6,0,1,5632,17,8617846129
1559,7228530,3688928,10917458,0,0,0,12288,8,5626086182
1560,7229230,11001432,18230662,6,0,1,1024,17,3289415714
1561,7231080,10999605,18230685,6,0,1,7680,17,2142020909
1562,7231230,10999478,18230708,6,0,1,512,17,8050890166
1563,7234100,10996631,18230731,9,0,1,14848,4,6815035443
1564,7240960,10989794,18230754,6,0,1,512,17,5610030445
1565,7246960,3881968,11128928,9,0,0,73728,4,9502522379
1566,7250840,10979937,18230777,6,0,1,1536,17,1796036999
1567,7251060,10979740,18230800,0,0,1,512,8,1812325280
1568,7256260,11078691,18334951,3,0,1,77312,21,7087325786
1569,7262970,11171463,18434433,6,0,1,512,17,3374794975
1570,7263550,3994709,11258259,9,0,0,94720,4,2286315555
1571,7264340,11170116,18434456,9,0,1,1536,4,2112711181
1572,7271010,11163469,18434479,9,0,1,512,4,6712285488
1573,7273230,11163298,18436528,6,0,1,5120,17,5994146742
1574,7275640,3757583,11033223,0,0,0,6656,8,2678419896
1575,7279440,3665532,10944972,9,0,0,512,4,2095729848
1576,7282950,11154858,18437808,0,0,1,14336,8,4078487170
1577,7292720,11177628,18470348,0,0,1,14848,8,2183260053
1578,7296650,11241970,18538620,0,0,1,2560,8,3150318822
1579,7302130,11239641,18541771,0,0,1,5120,8,7696225586
1580,7302140,3776413,11078553,9,0,0,16896,4,3392761832
1581,7305910,11238447,18544357,0,0,1,4096,8,6645705170
1582,7308660,11284676,18593336,3,0,1,75264,21,8903682072
1583,7309420,4256821,11566241,0,0,0,33280,8,8883278685
1584,7311030,11290223,18601253,6,0,1,6144,17,8130670152
1585,7311270,3917384,11228654,9,0,0,85504,4,4818997676
1586,7317300,11285899,18603199,9,0,1,3072,4,6620433416
1587,7317720,11286465,18604185,9,0,1,1536,4,8178414037
1588,7317920,11286611,18604531,9,0,1,512,4,3531711425
1589,7320620,11286177,18606797,6,0,1,3584,17,10894130
1590,7323350,4061807,11385157,9,0,0,140800,4,5206303151
1591,7324740,4060596,11385336,7,0,0,512,21,8726648722
1592,7325070,4231000,11556070,0,0,0,67584,8,8065443412
1593,7325790,4196876,11522666,9,0,0,2048,4,567053128
1594,7326140,11280913,18607053,3,0,1,9216,21,8158060505
1595,7338460,3856787,11195247,7,0,0,512,21,6256956644
1596,7344700,3962462,11307162,0,0,0,50176,8,8831043294
1597,7347260,3994974,11342234,9,0,0,8192,4,2359451770
1598,7351090,4145605,11496695,0,0,0,36352,8,7668462715
1599,7361840,4456751,11818591,9,0,0,54272,4,3714097427
1600,7363331,11269952,18633283,7,0,1,3072,21,2563196978
1601,7366670,11273185,18639855,9,0,1,6656,4,464983826
1602,7379510,11264595,18644105,6,0,1,5120,17,3821609159
1603,7392830,4129189,11522019,9,0,0,80384,4,7226301179
1604,7393530,4035003,11428533,7,0,0,1536,21,2261158173
1605,7404210,11241908,18646118,6,0,1,4096,17,8766747428
1606,7409480,3902580,11312060,9,0,0,1024,4,1423586674
1607,7411820,11323932,18735752,3,0,1,47616,21,6252332997
1608,7412521,11324217,18736738,7,0,1,1536,21,4905389709
1609,7419020,4278448,11697468,0,0,0,103424,8,6111542307
1610,7420860,11316224,18737084,9,0,1,512,4,5064331325
1611,7422550,11356012,18778562,3,0,1,79360,21,7569835782
1612,7424620,11354928,18779548,6,0,1,1536,17,8619004470
1613,7437940,11680846,19118786,3,0,1,229376,21,10488207002
1614,7443070,11700315,19143385,3,0,1,36352,21,9132610632
1615,7452040,11703760,19155800,6,0,1,1024,17,1069172672
1616,7452920,4140611,11593531,0,0,0,36864,8,10616264479
1617,7454970,4160587,11615557,7,0,0,1024,21,3431182184
1618,7456290,4079165,11535455,0,0,0,12800,8,10162417599
1619,7464640,11691586,19156226,9,0,1,13824,4,7356181409
1620,7486360,4179573,11665933,9,0,0,41472,4,6463406361
1621,7491470,11688563,19180033,6,0,1,9728,17,59540881
1622,7494820,4259137,11753957,7,0,0,1024,21,2560112761
1623,7497650,11684009,19181659,6,0,1,2560,17,6946035765
1624,7499070,4419497,11918567,9,0,0,73728,4,5699511089
1625,7500990,4199941,11700931,9,0,0,11264,4,1166586726
1626,7506501,11675619,19182120,7,0,1,10240,21,780408228
1627,7507561,11675635,19183196,5,0,1,13312,25,2559664541
1628,7526960,11658200,19185160,3,0,1,1024,21,3518199047
1629,7533381,11654045,19187426,5,0,1,3584,25,1768597560
1630,7536270,11655982,19192252,0,0,1,7680,8,10572853666
1631,7537671,11663217,19200888,7,0,1,3584,21,10114872097
1632,7548660,11658271,19206931,3,0,1,19456,21,8244299031
1633,7551160,4190116,11741276,9,0,0,25600,4,5948847047
1634,7552740,11723558,19276298,3,0,1,80384,21,7981973095
1635,7558481,11720083,19278564,5,0,1,3584,25,9214889702
1636,7572200,4200766,11772966,7,0,0,2048,21,6747315939
1637,7582450,4237637,11820087,0,0,0,4608,8,3998687698
1638,7587630,11692522,19280152,3,0,1,15872,21,174463421
1639,7592500,11691783,19284283,6,0,1,3072,17,941512079
1640,7620810,11667339,19288149,6,0,1,6144,17,1610952682
1641,7623910,4321795,11945705,0,0,0,1536,8,2810782973
1642,7626290,4318127,11944417,9,0,0,12800,4,7095162635
1643,7626980,11664524,19291504,0,0,1,512,8,10590705876
1644,7631540,11664150,19295690,0,0,1,6656,8,692003230
1645,7632269,4420967,12053236,4,0,0,43520,25,3117718935
1646,7653660,4498306,12151966,9,0,0,117248,4,1555710375
1647,7654690,11642946,19297636,6,0,1,3072,17,2578688499
1648,7663570,4396510,12060080,0,0,0,18944,8,44292462
1649,7670830,11627152,19297982,0,0,1,512,8,4383953813
1650,7673430,11624898,19298328,6,0,1,512,17,123132049
1651,7679450,11621144,19300594,2,0,1,3584,19,42004387
1652,7681241,11621299,19302540,7,0,1,3072,21,5873412030
1653,7682690,11637218,19319908,0,0,1,6144,8,891237973
1654,7685230,11635344,19320574,6,0,1,1024,17,2087983247
1655,7685670,4611788,12297458,9,0,0,19456,4,4903883655
1656,7693560,11627360,19320920,9,0,1,512,4,299180077
1657,7707500,11613779,19321279,6,0,1,9728,17,9941684965
1658,7710960,11628942,19339902,0,0,1,4608,8,7444068708
1659,7714470,4670303,12384773,9,0,0,29184,4,7662275118
1660,7723101,11632162,19355263,7,0,1,12288,21,1190164900
1661,7732470,4481608,12214078,0,0,0,16384,8,3341910116
1662,7745510,11614051,19359561,6,0,1,3072,17,5318017438
1663,7747630,11616332,19363962,2,0,1,3072,19,2850960421
1664,7750220,11616008,19366228,0,0,1,3584,8,4892241138
1665,7752380,4422402,12174782,7,0,0,1536,21,173315142
1666,7753651,11619900,19373551,7,0,1,14336,21,5653505943
1667,7757380,4394921,12152301,7,0,0,1024,21,65488825
1668,7760480,11615657,19376137,0,0,1,4096,8,4768290851
1669,7762570,11625528,19388098,6,0,1,10240,17,1220103398
1670,7762620,11679037,19441657,2,0,1,1536,19,6402219913
1671,7762820,11683343,19446163,0,0,1,7168,8,10488830205
1672,7765180,4756208,12521388,9,0,0,118784,4,822107638
1673,7770750,11676719,19447469,2,0,1,2048,19,4769099277
1674,7773081,11677614,19450695,7,0,1,5120,21,2375988870
1675,7773570,4424282,12197852,7,0,0,512,21,5732858436
1676,7775301,11676700,19452001,7,0,1,2048,21,3074226089
1677,7779140,11673322,19452462,0,0,1,10240,8,9026780830
1678,7788760,4587098,12375858,0,0,0,45568,8,9456464503
1679,7788790,4429497,12218287,7,0,0,1024,21,5213208780
1680,7790310,4843165,12633475,0,0,0,152576,8,2904870154
1681,7796640,4402637,12199277,7,0,0,1024,21,2719303836
1682,7797130,11704843,19501973,0,0,1,2048,8,3113504651
1683,7816411,11685585,19501996,7,0,1,4096,21,6087294980
1684,7818180,11683839,19502019,0,0,1,1536,8,821195019
1685,7826070,4565454,12391524,9,0,0,1024,4,6463361558
1686,7826080,11675962,19502042,2,0,1,512,19,9661456505
1687,7828300,4839111,12667411,0,0,0,10752,8,4795136032
1688,7828770,11673303,19502073,2,0,1,1536,19,7810021045
1689,7833650,11668446,19502096,2,0,1,14848,19,6667458067
1690,7839740,4809159,12648899,9,0,0,29696,4,8356629303
1691,7847290,11656232,19503522,0,0,1,512,8,6599290405
1692,7850250,4687046,12537296,7,0,0,1024,21,9833561945
1693,7850970,11654140,19505110,6,0,1,15872,17,10476833906
1694,7876331,11636820,19513151,7,0,1,7168,21,532773991
1695,7880150,11653948,19534098,0,0,1,19456,8,5095249489
1696,7893320,4960982,12854302,9,0,0,68608,4,10096172797
1697,7904670,4517046,12421716,9,0,0,19456,4,3335746831
1698,7912530,11635000,19547530,0,0,1,4608,8,2905099527
1699,7918940,4657119,12576059,8,0,0,63488,1,1070568859
1700,7927170,11620383,19547553,2,0,1,2560,19,6787215123
1701,7932570,4652317,12584887,9,0,0,512,4,3102428053
1702,7934000,11613576,19547576,0,0,1,1536,8,8794297419
1703,7938770,4461966,12400736,7,0,0,1536,21,831731413
1704,7941240,11606359,19547599,6,0,1,2048,17,10135883916
1705,7955410,4775114,12730524,9,0,0,44032,4,7007918225
1706,7965380,11582242,19547622,2,0,1,2048,19,6011559774
1707,7971140,4418968,12390108,8,0,0,17408,1,3914372787
1708,7973130,4454143,12427273,7,0,0,512,21,1719075838
1709,7983471,11567129,19550600,7,0,1,5632,21,1674969776
1710,8001770,11569666,19571436,6,0,1,2048,17,6894742469
1711,8004711,11566756,19571467,7,0,1,3072,21,8159242481
1712,8009790,11561700,19571490,0,0,1,1024,8,2953808450
1713,8010770,11574555,19585325,0,0,1,11776,8,5616931948
1714,8013760,4684713,12698473,0,0,0,10752,8,9633659447
1715,8014461,11574410,19588871,7,0,1,5632,21,8754705737
1716,8016131,11573086,19589217,7,0,1,512,21,67185908
1717,8021541,11579035,19600576,7,0,1,9216,21,9241432053
1718,8024910,11579532,19604442,6,0,1,6144,17,247264578
1719,8033440,4683645,12717085,0,0,0,57856,8,9310444545
1720,8038411,11567337,19605748,7,0,1,2048,21,7433262704
1721,8041351,11643449,19684800,7,0,1,4608,21,2213212667
1722,8044020,4717750,12761770,0,0,0,101888,8,837096096
1723,8047850,11651417,19699267,0,0,1,2560,8,669806816
1724,8058900,11640390,19699290,0,0,1,11264,8,1015579558
1725,8059471,11639842,19699313,7,0,1,2560,21,1459782394
1726,8064890,11634446,19699336,6,0,1,2560,17,1542918591
1727,8068240,4567286,12635526,9,0,0,6656,4,1144792515
1728,8069340,11630853,19700193,0,0,1,1536,8,8639930588
1729,8072060,11641804,19713864,3,0,1,2048,21,8152906244
1730,8075370,11638517,19713887,0,0,1,5632,8,4483665095
1731,8083420,4947084,13030504,0,0,0,66048,8,3844211437
1732,8085181,11642744,19727925,7,0,1,21504,21,9391640436
1733,8092830,11635441,19728271,0,0,1,512,8,3118418874
1734,8097590,4734046,12831636,8,0,0,14848,1,10179951015
1735,8101320,4660964,12762284,7,0,0,1536,21,7603551257
1736,8115320,4538129,12653449,7,0,0,1024,21,3887694263
1737,8116970,11644041,19761011,3,0,1,21504,21,4184255644
1738,8130260,11631417,19761677,6,0,1,1024,17,9670305761
1739,8132980,11629363,19762343,6,0,1,1024,17,2750833227
1740,8142330,4627368,12769698,9,0,0,18944,4,5846911872
1741,8145960,11921940,20067900,3,0,1,188928,21,9840153785
1742,8149340,11918906,20068246,0,0,1,512,8,6297970380
1743,8152409,11916503,20068912,6,0,1,1024,17,10593164461
1744,8156620,4574083,12730703,7,0,0,512,21,8827251761
1745,8157010,4765904,12922914,8,0,0,15872,1,1415677390
1746,8158460,4616759,12775219,7,0,0,512,21,9237191434
1747,8160850,4793150,12954000,8,0,0,73216,1,10726960771
1748,8167300,4485814,12653114,7,0,0,512,21,2860391154
1749,8176530,4721412,12897942,9,0,0,29696,4,8841409693
1750,8176949,11900594,20077543,6,0,1,1536,17,10126272005
1751,8185460,5063483,13248943,0,0,0,92160,8,3096535970
1752,8188400,11889166,20077566,0,0,1,512,8,10713069641
1753,8188750,4710784,12899534,7,0,0,3584,21,1311396597
1754,8197170,4955777,13152947,8,0,0,117760,1,1831358966
1755,8207069,11870520,20077589,6,0,1,2048,17,10452931019
1756,8209470,11868337,20077807,0,0,1,7168,8,1116812205
1757,8218530,11859300,20077830,0,0,1,12800,8,6087667834
1758,8222550,11862036,20084586,0,0,1,512,8,6754807351
1759,8223400,11862492,20085892,0,0,1,2048,8,1163372440
1760,8226600,5022885,13249485,0,0,0,1024,8,373893703
1761,8229690,4804650,13034340,9,0,0,4096,4,3460165505
1762,8238840,4727888,12966728,0,0,0,7168,8,10261354057
1763,8238900,4740749,12979649,9,0,0,1024,4,3957470839
1764,8244340,11843030,20087370,0,0,1,1024,8,4946717984
1765,8246620,11843656,20090276,0,0,1,4608,8,1152389705
1766,8249650,11840972,20090622,6,0,1,512,17,5316104182
1767,8254300,4710221,12964521,8,0,0,14848,1,9839276382
1768,8262240,11829688,20091928,6,0,1,2048,17,8645943716
1769,8263890,11829344,20093234,0,0,1,2048,8,5076424638
1770,8269050,4690901,12959951,9,0,0,19456,4,3340836153
1771,8274570,11892282,20166852,3,0,1,44032,21,8258863886
1772,8277650,4778892,13056542,8,0,0,27648,1,2617396201
1773,8278730,5239878,13518608,7,0,0,1024,21,4912631968
1774,8284880,5103410,13388290,8,0,0,119808,1,3225497104
1775,8290750,11876125,20166875,0,0,1,1024,8,3928435185
1776,8312560,5344003,13656563,9,0,0,50688,4,6769386433
1777,8330100,4826793,13156893,8,0,0,12800,1,10578995216
1778,8342020,11824878,20166898,6,0,1,3072,17,2963853987
1779,8342360,11826612,20168972,6,0,1,10752,17,2010843089
1780,8348660,11820335,20168995,3,0,1,17920,21,8353534557
1781,8353910,11848061,20201971,3,0,1,40448,21,7908126713
1782,8355160,4677707,13032867,8,0,0,7680,1,5438498282
1783,8356060,5164414,13520474,7,0,0,4096,21,9913633238
1784,8359670,4837757,13197427,7,0,0,512,21,4106734505
1785,8359830,11845520,20205350,6,0,1,3584,17,4354747018
1786,8367150,11847235,20214385,4,0,1,3584,25,10003648210
1787,8372020,5206665,13578685,8,0,0,190976,1,6289028960
1788,8376050,11874299,20250349,3,0,1,1536,21,4964691015
1789,8382480,5230301,13612781,8,0,0,1536,1,5211336889
1790,8383850,11939946,20323796,3,0,1,68096,21,10540840268
1791,8388800,4901660,13290460,0,0,0,31744,8,6799459670
1792,8391030,5228349,13619379,8,0,0,21504,1,7496565966
1793,8401950,11930940,20332890,0,0,1,14336,8,1258695241
1794,8403200,11929713,20332913,4,0,1,4096,25,1773695812
1795,8404300,4898490,13302790,7,0,0,512,21,10462156098
1796,8412730,11924345,20337075,3,0,1,12288,21,4688242035
1797,8415960,11922101,20338061,4,0,1,1536,25,8204842375
1798,8421980,11967331,20389311,3,0,1,87552,21,8325716101
1799,8423430,11986241,20409671,4,0,1,6656,25,4588752436
1800,8441250,4591796,13033046,7,0,0,512,21,8994133495
1801,8448100,4941773,13389873,9,0,0,5120,4,702204081
1802,8448350,5237009,13685359,8,0,0,93696,1,2355620135
1803,8459170,11952447,20411617,3,0,1,3072,21,5039023436
1804,8461960,11964068,20426028,0,0,1,1536,8,1482161155
1805,8465180,5143476,13608656,9,0,0,65536,4,8467738510
1806,8465550,11960688,20426238,4,0,1,12288,25,7504325391
1807,8475130,5387417,13862547,0,0,0,77312,8,1677995022
1808,8477960,11956501,20434461,3,0,1,7680,21,9076158303
1809,8494720,12049871,20544591,3,0,1,154112,21,3269212910
1810,8502530,4948344,13450874,8,0,0,29184,1,2808920039
1811,8505350,12039587,20544937,6,0,1,512,17,4082236387
1812,8508550,12036733,20545283,0,0,1,512,8,3578077413
1813,8510400,12036189,20546589,6,0,1,2048,17,5521720352
1814,8515520,5256937,13772457,8,0,0,100352,1,8095728685
1815,8520820,5262736,13783556,8,0,0,36352,1,10641193611
1816,8525940,4881565,13407505,9,0,0,29184,4,452025707
1817,8561140,5245527,13806667,8,0,0,75776,1,7158043863
1818,8565450,11984365,20549815,0,0,1,5120,8,3558877297
1819,8578790,11975851,20554641,4,0,1,7680,25,8616463483
1820,8593400,5063388,13656788,7,0,0,512,21,1587074580
1821,8600680,5095543,13696223,8,0,0,24064,1,317901179
1822,8602860,11954047,20556907,0,0,1,3584,8,1455510543
1823,8609070,11948503,20557573,0,0,1,1024,8,3898840737
1824,8610990,5275049,13886039,0,0,0,32256,8,10181902988
1825,8621590,4990700,13612290,0,0,0,11776,8,6850628908
1826,8623390,11935489,20558879,0,0,1,2048,8,7591193339
1827,8625000,11934225,20559225,0,0,1,512,8,8649499520
1828,8632660,11929471,20562131,4,0,1,4608,25,7720641874
1829,8635560,5053308,13688868,9,0,0,9216,4,3480586434
1830,8635570,5345411,13980981,7,0,0,512,21,7069085622
1831,8648020,11914777,20562797,4,0,1,1024,25,3797181496
1832,8664230,5021776,13686006,7,0,0,2048,21,7505251052
1833,8667180,5066133,13733313,7,0,0,1536,21,7431420346
1834,8683510,11880273,20563783,4,0,1,1536,25,5161876466
1835,8683970,4708422,13392392,0,0,0,8192,8,214713895
1836,8685230,11881779,20567009,0,0,1,5120,8,5271981322
1837,8689100,5173626,13862726,7,0,0,512,21,2455639132
1838,8697830,5115108,13812938,0,0,0,20480,8,7569620645
1839,8711480,11856835,20568315,0,0,1,2048,8,7134361534
1840,8716260,5434453,14150713,7,0,0,512,21,5565131487
1841,8741520,4838201,13579721,7,0,0,512,21,5203588371
1842,8745719,11824222,20569941,1,0,1,2560,5,6137246768
1843,8747830,5400684,14148514,9,0,0,87040,4,5103646310
1844,8749320,11823207,20572527,4,0,1,4096,25,10435434949
1845,8758261,11816657,20574918,5,0,1,1024,25,704323613
1846,8768321,11810143,20578464,5,0,1,5632,25,9235981992
1847,8776470,5501254,14277724,9,0,0,35328,4,148735087
1848,8785620,5138320,13923940,7,0,0,2560,21,7373225129
1849,8788769,11810317,20599086,1,0,1,22528,5,7078682361
1850,8794100,11808135,20602235,9,0,1,2048,4,1583596782
1851,8794890,5081298,13876188,9,0,0,29696,4,3441012395
1852,8794930,5185872,13980802,9,0,0,7680,4,5646767992
1853,8794981,11808637,20603618,5,0,1,14848,25,8929554825
1854,8796060,5123217,13919277,7,0,0,512,21,7263251663
1855,8802920,11804355,20607275,0,0,1,9216,8,1549786723
1856,8807690,11823030,20630720,4,0,1,512,25,1519253109
1857,8811530,5055587,13867117,8,0,0,14336,1,1669477652
1858,8819601,11811478,20631079,5,0,1,9728,25,5016373404
1859,8825370,11837844,20663214,0,0,1,8192,8,8114455461
1860,8835670,4743826,13579496,9,0,0,2560,4,7384762687
1861,8850490,11815489,20665979,0,0,1,2048,8,4045458085
1862,8860410,11805723,20666133,0,0,1,8704,8,3470003363
1863,8862550,11822163,20684713,0,0,1,7680,8,2875443144
1864,8863631,11821543,20685174,5,0,1,10240,25,9413804446
1865,8869010,5124531,13993541,8,0,0,15872,1,3227078399
1866,8876860,5271833,14148693,7,0,0,512,21,8293614757
1867,8880190,4858985,13739175,9,0,0,14848,4,2095927256
1868,8881820,5305688,14187508,7,0,0,512,21,8294492380
1869,8883980,5234181,14118161,9,0,0,5632,4,1047656627
1870,8905220,11780620,20685840,4,0,1,1024,25,1523149178
1871,8908749,11784836,20693585,1,0,1,30720,5,9552848486
1872,8915031,11780394,20695425,5,0,1,12288,25,5795262984
1873,8918379,11836569,20754948,1,0,1,24064,5,699924191
1874,8921360,5127967,14049327,0,0,0,48128,8,5548743105
1875,8926429,11914854,20841283,1,0,1,44032,5,2315926640
1876,8929440,5408188,14337628,8,0,0,155136,1,1790732601
1877,8930221,11912688,20842909,5,0,1,2560,25,10389525149
1878,8945890,4940336,13886226,7,0,0,512,21,3617963068
1879,8946039,11927335,20873374,1,0,1,8704,5,52909114
1880,8947711,11928889,20876600,5,0,1,5120,25,5495746416
1881,8950091,11929735,20879826,5,0,1,5120,25,8876906109
1882,8950350,4994327,13944677,0,0,0,11776,8,1239237919
1883,8950570,5162111,14112681,6,0,0,23040,17,10133809367
1884,8957690,5482485,14440175,6,0,0,91136,17,510131697
1885,8960780,5281285,14242065,9,0,0,8704,4,2338122930
1886,8965809,11992123,20957932,1,0,1,14848,5,172021980
1887,8978900,5247205,14226105,6,0,0,2560,17,6345024879
1888,8987140,5025962,14013102,7,0,0,512,21,5167922235
1889,8989629,11990053,20979682,1,0,1,33792,5,9709047165
1890,8991560,4827671,13819231,0,0,0,2560,8,8563457906
1891,8995090,5168474,14163564,7,0,0,512,21,3643795885
1892,8995160,5228264,14223424,9,0,0,18432,4,6141426275
1893,8997700,4989119,13986819,0,0,0,7168,8,478866457
1894,9002199,12008637,21010836,1,0,1,26112,5,926318935
1895,9022670,12054005,21076675,3,0,1,32768,21,7786847628
1896,9027420,4985503,14012923,0,0,0,20992,8,4008894793
1897,9031129,12181309,21212438,1,0,1,96768,5,9980006912
1898,9032900,12263306,21296206,0,0,1,3072,8,10643465235
1899,9035220,5145693,14180913,7,0,0,1024,21,4466060106
1900,9043880,5504925,14548805,8,0,0,58368,1,4627943462
1901,9044980,5207568,14252548,0,0,0,34304,8,8694797583
1902,9047810,5400344,14448154,6,0,0,26112,17,7196502673
1903,9047940,5212040,14259980,8,0,0,14848,1,9764664321
1904,9049331,12246898,21296229,5,0,1,4608,25,2165774673
1905,9050200,5411472,14461672,8,0,0,24064,1,6924472123
1906,9054300,5422418,14476718,7,0,0,1024,21,4228642075
1907,9056410,5454810,14511220,0,0,0,14848,8,9539669888
1908,9057690,5195193,14252883,6,0,0,1024,17,554150714
1909,9069640,5498765,14568405,9,0,0,46592,4,9088275349
1910,9092520,5131395,14223915,0,0,0,1536,8,8779962803
1911,9094831,12208308,21303139,5,0,1,8704,25,3811041905
1912,9102289,12235941,21338230,1,0,1,89088,5,323659891
1913,9115520,5047865,14163385,8,0,0,16896,1,8437751232
1914,9128150,5516041,14644191,6,0,0,67072,17,8047757016
1915,9132149,12244573,21376722,1,0,1,21504,5,9388102949
1916,9135880,5370793,14506673,9,0,0,81408,4,10280620518
1917,9137339,12289359,21426698,1,0,1,100864,5,2063524568
1918,9142471,12310004,21452475,5,0,1,7680,25,6909373397
1919,9142479,12313029,21455508,1,0,1,23040,5,9782067462
1920,9145070,5094320,14239390,8,0,0,18432,1,10175576520
1921,9146349,12315800,21462149,1,0,1,6144,5,3661250899
1922,9146799,12316336,21463135,1,0,1,1536,5,5836814404
1923,9151420,5521153,14672573,7,0,0,3584,21,5902208841
1924,9157191,12306930,21464121,5,0,1,1536,25,1150832558
1925,9163100,5188850,14351950,6,0,0,18944,17,9583615085
1926,9170180,5278176,14448356,7,0,0,512,21,7836602397
1927,9174890,5301470,14476360,0,0,0,13824,8,8598942669
1928,9175639,12288828,21464467,8,0,1,512,1,7038373381
1929,9177510,5160545,14338055,6,0,0,1024,17,2927634378
1930,9193800,5172394,14366194,0,0,0,512,8,5458042895
1931,9201590,5192924,14394514,0,0,0,1024,8,7389640932
1932,9203019,12263074,21466093,8,0,1,2560,1,1726890535
1933,9218949,12254052,21473001,1,0,1,7168,5,7633379931
1934,9219659,12254008,21473667,8,0,1,1024,1,7226252719
1935,9223889,12250342,21474231,1,0,1,10752,5,1172079782
1936,9244530,5337525,14582055,9,0,0,10752,4,5878435225
1937,9246129,12248961,21495090,8,0,1,8192,1,10056155081
1938,9255280,5298719,14553999,9,0,0,14848,4,5612351632
1939,9258090,5492154,14750244,8,0,0,61952,1,1486739106
1940,9260480,5259880,14520360,8,0,0,29696,1,1939205608
1941,9268341,12228055,21496396,7,0,1,2048,21,4097590459
1942,9281529,12219399,21500928,1,0,1,7168,5,2957243189
1943,9292420,5156115,14448535,0,0,0,512,8,8578384428
1944,9294599,12207315,21501914,1,0,1,1536,5,1732382897
1945,9298440,5251012,14549452,0,0,0,2048,8,1632843638
1946,9317070,5449288,14766358,9,0,0,51712,4,1460978944
1947,9317330,5378157,14695487,0,0,0,2048,8,6216705884
1948,9324111,12181349,21505460,5,0,1,5632,25,10048992146
1949,9324830,5452456,14777286,9,0,0,10752,4,650841834
1950,9326030,5194922,14520952,0,0,0,1536,8,2082827702
1951,9326650,5404695,14731345,9,0,0,47616,4,5543743816
1952,9338470,5187024,14525494,7,0,0,512,21,8309785645
1953,9339350,5274080,14613430,7,0,0,512,21,10393355398
1954,9339860,5242530,14582390,9,0,0,1024,4,3878372652
1955,9344100,5517859,14861959,7,0,0,3584,21,7463778366
1956,9345260,12161506,21506766,9,0,1,2048,4,7510691022
1957,9347031,12160401,21507432,5,0,1,11264,25,2044149508
1958,9355940,5236239,14592179,8,0,0,7168,1,4259981300
1959,9363310,12160492,21523802,4,0,1,4608,25,3011831101
1960,9374150,5318608,14692758,9,0,0,512,4,4210818792
1961,9380560,5386133,14766693,0,0,0,1024,8,7018624642
1962,9380700,5190555,14571255,0,0,0,512,8,4122579073
1963,9384481,12156264,21540745,5,0,1,1024,25,514372718
1964,9384650,12156761,21541411,0,0,1,1024,8,32021784
1965,9404830,5239540,14644370,0,0,0,512,8,3337708393
1966,9404860,5402585,14807445,7,0,0,1024,21,4450308364
1967,9405050,5345529,14750579,9,0,0,1024,4,2775679798
1968,9417960,5389150,14807110,0,0,0,512,8,6663058990
1969,9431360,5241813,14673173,9,0,0,512,4,1349119816
1970,9444939,12097138,21542077,8,0,1,1024,1,5612275198
1971,9445780,5444821,14890601,9,0,0,512,4,2995882040
1972,9461290,12081248,21542538,6,0,1,10240,17,3659108942
1973,9466440,12077084,21543524,0,0,1,1536,8,6505624545
1974,9473610,5080568,14554178,7,0,0,512,21,5067553732
1975,9497130,5309801,14806931,8,0,0,19968,1,6950289968
1976,9501370,12048440,21549810,0,0,1,5120,8,2508520373
1977,9502660,5100627,14603287,7,0,0,512,21,2594260271
1978,9510419,12043544,21553963,8,0,1,512,1,3088923808
1979,9511729,12042580,21554309,1,0,1,512,5,9950975688
1980,9524160,5068666,14592826,0,0,0,2048,8,2218754778
1981,9527999,12026656,21554655,8,0,1,512,1,221200913
1982,9529309,12026012,21555321,8,0,1,1024,1,1812245470
1983,9533310,12022997,21556307,6,0,1,1536,17,1338400610
1984,9534420,12022553,21556973,0,0,1,1024,8,4142323217
1985,9534809,12022420,21557229,8,0,1,9216,1,241297965
1986,9551960,5328509,14880469,0,0,0,512,8,527479481
1987,9554420,5279780,14834200,0,0,0,512,8,1935628355
1988,9554709,12023063,21577772,8,0,1,5632,1,9234246452
1989,9569380,5392471,14961851,5,0,0,114688,25,869685260
1990,9572240,12008438,21580678,0,0,1,4608,8,7082366214
1991,9582690,5277975,14860665,8,0,0,86016,1,4716877729
1992,9591670,5052902,14644572,0,0,0,512,8,725747392
1993,9607690,11976534,21584224,0,0,1,5632,8,4163582668
1994,9609530,5157350,14766880,0,0,0,512,8,6842000394
1995,9614200,5260728,14874928,0,0,0,3072,8,4379557002
1996,9614250,11975120,21589370,0,0,1,8192,8,3997994105
1997,9616450,11976466,21592916,9,0,1,5632,4,3689107715
1998,9617040,11980258,21597298,0,0,1,2560,8,3720533415
1999,9619110,11981734,21600844,0,0,1,5632,8,10134617846
2000,9628600,5200735,14829335,8,0,0,16896,1,9967099801
2001,9633450,5334820,14968270,8,0,0,20992,1,9589001850
2002,9644260,11957570,21601830,4,0,1,1536,25,5011548419
2003,9648410,5225521,14873931,0,0,0,2048,8,3171834362
2004,9649220,5319853,14969073,8,0,0,2560,1,1760883449
2005,9656680,11945509,21602189,0,0,1,9728,8,2101436131
2006,9656760,5346922,15003682,8,0,0,36352,1,9376173412
2007,9678490,11989093,21667583,0,0,1,1024,8,7614811650
2008,9679400,11988206,21667606,0,0,1,512,8,2294223964
2009,9681210,11986419,21667629,0,0,1,1024,8,5743210100
2010,9681919,11985733,21667652,8,0,1,512,1,8063784168
2011,9687640,11980035,21667675,0,0,1,1536,8,6342464310
2012,9689580,5217488,14907068,0,0,0,512,8,4292043938
2013,9709510,5262113,14971623,7,0,0,7168,21,8525452340
2014,9721649,11946049,21667698,6,0,1,7168,17,9620199380
2015,9734780,11933432,21668212,6,0,1,7168,17,5440426204
2016,9742280,11925955,21668235,6,0,1,4608,17,10235903844
2017,9744110,5162779,14906889,8,0,0,13312,1,4618824137
2018,9748520,5112324,14860844,0,0,0,512,8,7700979325
2019,9756260,5361933,15118193,0,0,0,1536,8,10553593487
2020,9756860,11911398,21668258,4,0,1,7680,25,10403724038
2021,9757870,11918575,21676445,6,0,1,32256,17,7691591196
2022,9763670,5351526,15115196,0,0,0,512,8,1248046634
2023,9776310,5193098,14969408,7,0,0,1024,21,4620266454
2024,9788100,11939627,21727727,4,0,1,2560,25,1294534382
2025,9792460,5267088,15059548,7,0,0,512,21,2208522106
2026,9809119,11918631,21727750,1,0,1,512,5,7587003036
2027,9817290,11912084,21729374,0,0,1,7680,8,8928865085
2028,9818890,5207938,15026828,0,0,0,3072,8,2021113823
2029,9836920,11936398,21773318,6,0,1,29184,17,4652200556
2030,9837109,11960973,21798082,8,0,1,4608,1,9599032719
2031,9850469,11947979,21798448,8,0,1,1024,1,8712237453
2032,9851150,11947329,21798479,0,0,1,512,8,3512724227
2033,9859340,11942689,21802029,0,0,1,5632,8,986459094
2034,9860530,5171166,15031696,8,0,0,14336,1,3745600277
2035,9862951,11943584,21806535,5,0,1,7168,25,5581613548
2036,9862980,12148238,22011218,6,0,1,44544,17,8744374290
2037,9863049,5344395,15207444,3,0,0,84992,21,1366533233
2038,9864570,12369990,22234560,6,0,1,66048,17,9732732783
2039,9881439,12357223,22238662,8,0,1,6144,1,1055641899
2040,9882780,12409553,22292333,6,0,1,12288,17,10686426123
2041,9883200,12409156,22292356,4,0,1,9216,25,6645192412
2042,9898600,5239081,15137681,0,0,0,1024,8,4193297361
2043,9900910,5307764,15208674,8,0,0,3584,1,9644360427
2044,9901000,12418762,22319762,6,0,1,31744,17,7048565789
2045,9901140,5241659,15142799,0,0,0,512,8,5128331914
2046,9902250,12422024,22324274,0,0,1,3584,8,10688822876
2047,9914229,12426969,22341198,8,0,1,6656,1,7228629416
2048,9916600,12493635,22410235,3,0,1,4608,21,5182629063
2049,9916789,12498359,22415148,8,0,1,1024,1,10575390076
2050,9923730,12491441,22415171,0,0,1,1536,8,5064703351
2051,9929089,12486105,22415194,8,0,1,2560,1,3182760841
2052,9936469,12479106,22415575,8,0,1,6144,1,775648741
2053,9936480,5405316,15341796,8,0,0,18432,1,10611354934
2054,9944050,5288393,15232443,0,0,0,512,8,733011555
2055,9945440,5506305,15451745,8,0,0,28672,1,1785122665
2056,9946980,12468618,22415598,3,0,1,1536,21,9106026532
2057,9948569,12467052,22415621,8,0,1,512,1,6141843319
2058,9951370,5328814,15280184,0,0,0,512,8,3917923510
2059,9952380,12463264,22415644,0,0,1,512,8,5504625233
2060,9957220,5425973,15383193,0,0,0,512,8,6949665309
2061,9970780,12444887,22415667,0,0,1,1536,8,6152273852
2062,9986840,12428850,22415690,0,0,1,2560,8,222298524
2063,10010430,5270089,15280519,0,0,0,1024,8,43525150
2064,10016540,12399173,22415713,3,0,1,8704,21,825522121
2065,10018300,12403591,22421891,3,0,1,4096,21,2328338702
2066,10018659,12408386,22427045,8,0,1,3072,1,8281293606
2067,10025331,12443926,22469257,5,0,1,2048,25,6570593528
2068,10027990,5275787,15303777,0,0,0,1024,8,6042139389
2069,10030919,12439164,22470083,8,0,1,3072,1,361653513
2070,10052389,12417717,22470106,8,0,1,15872,1,10065865459
2071,10056940,12413189,22470129,0,0,1,2048,8,2884836732
2072,10068189,12401963,22470152,8,0,1,1536,1,8545960865
2073,10069489,12400686,22470175,8,0,1,1024,1,10415210114
2074,10075230,12394968,22470198,0,0,1,8704,8,9653423495
2075,10086910,5353564,15440474,0,0,0,1536,8,9703937982
2076,10095890,12377840,22473730,0,0,1,4608,8,454015062
2077,10096200,12400836,22497036,3,0,1,6656,21,8006682075
2078,10120299,12377723,22498022,8,0,1,1536,1,65852273
2079,10120710,5402515,15523225,7,0,0,512,21,5419083680
2080,10122820,5329329,15452149,8,0,0,1024,1,6235005851
2081,10123730,12377198,22500928,0,0,1,4608,8,3167683091
2082,10126090,12435615,22561705,6,0,1,28160,17,6053218988
2083,10144109,12454337,22598446,8,0,1,5120,1,6864175069
2084,10163279,12436793,22600072,8,0,1,2560,1,5624305789
2085,10163710,5597924,15761634,8,0,0,17920,1,8233195212
2086,10168670,5379289,15547959,8,0,0,8192,1,410715934
2087,10173520,12428498,22602018,3,0,1,3072,21,9293237809
2088,10180930,12422394,22603324,0,0,1,2048,8,7697680584
2089,10186570,12425126,22611696,3,0,1,13312,21,6559121967
2090,10194160,12422362,22616522,3,0,1,7680,21,4758352670
2091,10202280,12521653,22723933,6,0,1,45568,17,9779400857
2092,10209290,5267492,15476782,8,0,0,44032,1,3025197467
2093,10215790,12574135,22789925,3,0,1,2560,21,1780513806
2094,10221189,12569110,22790299,8,0,1,6144,1,6990363158
2095,10227580,5249537,15477117,0,0,0,1024,8,7766756411
2096,10235950,12554372,22790322,3,0,1,512,21,10262839089
2097,10236420,5691422,15927842,8,0,0,60416,1,10099971772
2098,10241790,12548555,22790345,3,0,1,1024,21,1065003123
2099,10252959,12560296,22813255,8,0,1,13312,1,3676073875
2100,10260170,5348998,15609168,8,0,0,1024,1,3805695112
2101,10279890,5363438,15643328,8,0,0,7168,1,7211407079
2102,10316019,12525197,22841216,8,0,1,12800,1,10340019471
2103,10330209,12538555,22868764,8,0,1,4608,1,7267160931
2104,10331890,5450247,15782137,8,0,0,27648,1,4777897936
2105,10336180,12556819,22892999,0,0,1,8704,8,7272121050
2106,10345169,12550595,22895764,8,0,1,11264,1,8141981478
2107,10350640,12562945,22913585,0,0,1,4608,8,6952964540
2108,10360020,12579300,22939320,3,0,1,1536,21,4168549093
2109,10367510,5406072,15773582,8,0,0,24064,1,376867398
2110,10367910,5237765,15605675,7,0,0,512,21,10342534245
2111,10372629,12567357,22939986,8,0,1,1024,1,10488582632
2112,10377619,12571379,22948998,8,0,1,14336,1,2276504335
2113,10393181,12557443,22950624,5,0,1,2560,25,2410503826
2114,10395310,5360841,15756151,8,0,0,59904,1,5061037503
2115,10404470,5227731,15632201,7,0,0,512,21,10217626933
2116,10408390,12542900,22951290,3,0,1,1024,21,2451362987
2117,10416950,12542829,22959779,0,0,1,7680,8,3776569294
2118,10418230,12543032,22961262,6,0,1,8192,17,1437878607
2119,10419070,12545418,22964488,3,0,1,5120,21,368625124
2120,10423901,12542853,22966754,5,0,1,3584,25,4437274147
2121,10430830,13172065,23602895,6,0,1,187904,17,10647455163
2122,10437691,13217462,23655153,5,0,1,29696,25,8431204363
2123,10442670,13233464,23676134,3,0,1,3072,21,2644097028
2124,10445901,13240612,23686513,5,0,1,3072,25,2816937499
2125,10450070,5161582,15611652,0,0,0,1024,8,1755181168
2126,10452980,5167613,15620593,7,0,0,2048,21,7719142549
2127,10460940,5254430,15715370,0,0,0,512,8,3494968818
2128,10460969,13252110,23713079,8,0,1,2048,1,6088098492
2129,10475000,13238102,23713102,3,0,1,512,21,6481226350
2130,10480329,13234075,23714404,8,0,1,2048,1,5185416470
2131,10483870,13230557,23714427,3,0,1,3584,21,5577334008
2132,10491360,13274352,23765712,0,0,1,3584,8,848137970
2133,10492270,5239834,15732104,7,0,0,2048,21,10502883253
2134,10496350,5204595,15700945,0,0,0,512,8,3900666997
2135,10496440,13269295,23765735,3,0,1,1536,21,1466292089
2136,10497680,5168792,15666472,7,0,0,512,21,10559812030
2137,10501900,5264281,15766181,8,0,0,14848,1,8713836131
2138,10508610,5286569,15795179,0,0,0,512,8,8229178169
2139,10513100,13252658,23765758,0,0,1,26624,8,4197916420
2140,10515360,5412840,15928200,7,0,0,1024,21,9861905016
2141,10518911,13340429,23859340,5,0,1,512,25,4651705308
2142,10520570,13338801,23859371,2,0,1,5120,19,7428330671
2143,10528281,13349040,23877321,5,0,1,4096,25,8673352715
2144,10536050,5286113,15822163,8,0,0,64512,1,875237135
2145,10539330,5283192,15822522,0,0,0,1024,8,9725260415
2146,10552371,13352945,23905316,5,0,1,2048,25,6753288986
2147,10553540,13355002,23908542,3,0,1,5120,21,8748318891
2148,10567240,13342608,23909848,3,0,1,2048,21,7989361261
2149,10572120,13342554,23914674,0,0,1,7680,8,1335237339
2150,10576581,13367365,23943946,5,0,1,3584,25,6724515661
2151,10586301,13387243,23973544,5,0,1,4096,25,2509192711
2152,10586690,5680850,16267540,8,0,0,46592,1,8830293227
2153,10593690,13379877,23973567,3,0,1,512,21,9227963635
2154,10605220,13368370,23973590,0,0,1,6144,8,7052568135
2155,10606260,5339086,15945346,8,0,0,33280,1,1610107416
2156,10620220,5326659,15946879,0,0,0,512,8,7255976807
2157,10639321,13337591,23976912,5,0,1,5120,25,287804219
2158,10649870,13327065,23976935,3,0,1,512,21,10374249120
2159,10666420,5184146,15850566,7,0,0,1024,21,8099667386
2160,10667480,13349557,24017037,3,0,1,13824,21,917943221
2161,10685920,13333703,24019623,3,0,1,4096,21,939696411
2162,10692040,5194447,15886487,7,0,0,512,21,7067756320
2163,10704340,5312355,16016695,7,0,0,2048,21,6527284036
2164,10752530,5040606,15793136,0,0,0,2560,8,3695453163
2165,10763460,13256509,24019969,3,0,1,512,21,10704079759
2166,10764610,13256345,24020955,3,0,1,1536,21,5232052851
2167,10765620,5068573,15834193,0,0,0,2048,8,685127526
2168,10768140,5356177,16124317,8,0,0,120832,1,5771066084
2169,10769890,13271536,24041426,6,0,1,16896,17,599748907
2170,10776060,13373412,24149472,3,0,1,2048,21,7349486642
2171,10790750,5334017,16124767,0,0,0,512,8,1633540300
2172,10795720,13392193,24187913,3,0,1,14336,21,4696200582
2173,10821840,5455042,16276882,0,0,0,512,8,9700897071
2174,10825070,13363202,24188272,4,0,1,9728,25,64627113
2175,10825210,13627729,24452939,6,0,1,42496,17,619375294
2176,10827160,5162845,15990005,8,0,0,38400,1,2510425189
2177,10841469,5246009,16087478,4,0,0,32768,25,1096799246
2178,10845130,5346303,16191433,7,0,0,2560,21,1705745335
2179,10845780,13645247,24491027,3,0,1,2560,21,7114684479
2180,10848950,5442929,16291879,7,0,0,1536,21,9143328123
2181,10871710,13619340,24491050,6,0,1,7680,17,8136771899
2182,10873579,5482650,16356229,4,0,0,162816,25,9188355009
2183,10877100,13700163,24577263,6,0,1,45056,17,7283287447
2184,10879810,13922953,24802763,6,0,1,116224,17,10461203692
2185,10895310,13953878,24849188,6,0,1,25600,17,10557010051
2186,10898820,14007639,24906459,9,0,1,2560,4,5964595170
2187,10905310,5394954,16300264,0,0,0,512,8,1959155007
2188,10916009,5601791,16517800,4,0,0,10240,25,7545873125
2189,10943930,5269849,16213779,8,0,0,15872,1,6184073069
2190,10966140,5309179,16275319,8,0,0,14336,1,8321429008
2191,10969949,5412472,16382421,4,0,0,46080,25,9025481384
2192,10986910,5227204,16214114,0,0,0,1024,8,9083893097
2193,10987430,13921784,24909214,6,0,1,4608,17,3919791068
2194,10996051,13913317,24909368,5,0,1,8704,25,8623999800
2195,11003190,5189358,16192548,7,0,0,3584,21,1525231073
2196,11005569,5219478,16225047,4,0,0,27648,25,5740815483
2197,11014430,13988885,25003315,6,0,1,34304,17,503193317
2198,11022310,5433261,16455571,8,0,0,42496,1,1140157304
2199,11022950,5144286,16167236,0,0,0,1024,8,3443159621
2200,11050870,14014434,25065304,6,0,1,41472,17,4257046140
2201,11053390,5348727,16402117,0,0,0,512,8,5188086484
2202,11059060,5065528,16124588,7,0,0,512,21,8749082411
2203,11059339,5637505,16696844,4,0,0,94208,25,10313216945
2204,11066680,5508603,16575283,7,0,0,512,21,3240741121
2205,11082240,5675640,16757880,0,0,0,512,8,622592862
2206,11088890,5467379,16556269,8,0,0,14848,1,10100697345
2207,11090100,14050933,25141033,6,0,1,34304,17,4183932708
2208,11096390,14118756,25215146,6,0,1,25088,17,8416387352
2209,11098440,14133804,25232244,6,0,1,41472,17,5123350699
2210,11103310,5193269,16296579,7,0,0,3072,21,3887910243
2211,11110440,5189415,16299855,0,0,0,3072,8,8159541471
2212,11111220,14231580,25342800,6,0,1,41472,17,1542856302
2213,11128510,14262195,25390705,3,0,1,19968,21,6398566278
2214,11128610,5096928,16225538,0,0,0,1536,8,2391290347
2215,11131600,5234737,16366337,7,0,0,1024,21,972944301
2216,11158910,5109899,16268809,0,0,0,2560,8,6835804803
2217,11174640,5039653,16214293,7,0,0,512,21,7608641444
2218,11183760,5289562,16473322,0,0,0,512,8,3026890287
2219,11209819,5218618,16428437,4,0,0,43520,25,2274629232
2220,11225350,5359218,16584568,7,0,0,1536,21,2230741557
2221,11230809,5204080,16434889,4,0,0,12288,25,4281559244
2222,11231150,14159578,25390728,4,0,1,1024,25,6430424140
2223,11232209,5329231,16561440,4,0,0,16896,25,5509548481
2224,11233580,5224175,16457755,7,0,0,512,21,6217727168
2225,11304950,5051458,16356408,8,0,0,512,1,5902939141
2226,11318200,14074041,25392241,4,0,1,3072,25,7278115963
2227,11345310,5353007,16698317,0,0,0,1024,8,3789863031
2228,11345850,4943928,16289778,8,0,0,512,1,4101800786
2229,11348979,5515598,16864577,4,0,0,40960,25,3359466512
2230,11350709,5307427,16658136,4,0,0,56832,25,4519935109
2231,11360339,5370628,16730967,4,0,0,106496,25,6074556132
2232,11366610,14026937,25393547,4,0,1,2048,25,7011454866
2233,11378139,5015644,16393783,4,0,0,1024,25,7513565579
2234,11379400,5250375,16629775,0,0,0,1024,8,2826414230
2235,11380470,14013538,25394008,3,0,1,10240,21,1834936107
2236,11385750,14008604,25394354,0,0,1,512,8,10182969527
2237,11386590,5243364,16629954,0,0,0,512,8,5466168987
2238,11400510,13997096,25397606,0,0,1,5120,8,718454749
2239,11404400,5051350,16455750,8,0,0,512,1,4814124580
2240,11407840,5199251,16607091,8,0,0,512,1,10683809490
2241,11412581,14005436,25418017,7,0,1,2560,21,8124078147
2242,11413520,5114956,16528476,7,0,0,1536,21,832557998
2243,11420579,5208861,16629440,4,0,0,34304,25,2995807016
2244,11422270,14000893,25423163,0,0,1,8192,8,1359601513
2245,11423699,14001090,25424789,8,0,1,2560,1,8864935130
2246,11424890,5087299,16512189,8,0,0,1536,1,3436945742
2247,11433680,13991455,25425135,4,0,1,512,25,9218172321
2248,11437620,13988501,25426121,4,0,1,1536,25,2700126068
2249,11447560,5114223,16561783,0,0,0,1024,8,3412433014
2250,11464740,14000362,25465102,4,0,1,16384,25,4378397797
2251,11470000,14031273,25501273,0,0,1,3072,8,2529124348
2252,11477690,14026489,25504179,4,0,1,4608,25,10004727645
2253,11495829,5334063,16829892,4,0,0,48640,25,10225347409
2254,11506280,13999525,25505805,4,0,1,2560,25,7275799053
2255,11519920,4936611,16456531,7,0,0,1536,21,360479951
2256,11528410,5170086,16698496,0,0,0,512,8,1617736605
2257,11530990,5276969,16807959,0,0,0,512,8,5494346259
2258,11536590,5014956,16551546,0,0,0,512,8,2261927082
2259,11547140,14002620,25549760,2,0,1,32256,19,8404198374
2260,11550300,4933816,16484116,0,0,0,512,8,4553474273
2261,11557340,5308196,16865536,0,0,0,3072,8,9721878570
2262,11566200,13985826,25552026,4,0,1,3584,25,6735687050
2263,11570189,5227626,16797815,4,0,0,23552,25,1184945178
2264,11581520,5116462,16697982,8,0,0,1536,1,8734601780
2265,11599620,4978891,16578511,7,0,0,1024,21,367511835
2266,11622009,5357549,16979558,4,0,0,10240,25,4093521781
2267,11622249,5110667,16732916,4,0,0,6144,25,2871716896
2268,11626689,4919570,16546259,4,0,0,512,25,5951064310
2269,11628520,14030986,25659506,0,0,1,14336,8,9585746744
2270,11647830,14027010,25674840,4,0,1,3072,25,2311261927
2271,11651740,14023123,25674863,0,0,1,1024,8,5615974821
2272,11662240,14012646,25674886,0,0,1,1024,8,2982517012
2273,11678510,4979805,16658315,7,0,0,512,21,6469683428
2274,11682739,5293676,16976415,4,0,0,64512,25,3937722429
2275,11683020,14000702,25683722,0,0,1,9728,8,8131853707
2276,11684360,14010032,25694392,2,0,1,11776,19,3929357791
2277,11695130,14121971,25817101,4,0,1,3072,25,10560068599
2278,11699140,5250410,16949550,0,0,0,41984,8,4243200132
2279,11702060,5142675,16844735,0,0,0,48640,8,6749121777
2280,11703960,14113164,25817124,4,0,1,2048,25,4490193504
2281,11704589,5328103,17032692,4,0,0,4608,25,3734671426
2282,11706890,14110257,25817147,4,0,1,2048,25,5261886137
2283,11707210,14109960,25817170,0,0,1,2048,8,4084017850
2284,11707260,5514475,17221735,7,0,0,75776,21,6318396950
2285,11711190,14125253,25836443,0,0,1,2048,8,6986019846
2286,11726720,14109746,25836466,4,0,1,6656,25,218945858
2287,11731510,14108816,25840326,4,0,1,17408,25,1948538987
2288,11732580,14209006,25941586,4,0,1,3072,25,1314371545
2289,11747179,14197313,25944492,1,0,1,4608,5,5687785969
2290,11751330,14233131,25984461,0,0,1,10240,8,6604712367
2291,11756269,14228215,25984484,1,0,1,2048,5,10618832622
2292,11757610,14266022,26023632,0,0,1,24064,8,1753760673
2293,11757810,14394661,26152471,4,0,1,12800,25,8924019557
2294,11769130,4968200,16737330,0,0,0,3072,8,3365492392
2295,11770019,14382475,26152494,1,0,1,512,5,7891422963
2296,11793810,14358707,26152517,0,0,1,1536,8,10386737252
2297,11807650,14344890,26152540,4,0,1,6144,25,2260558675
2298,11811780,5168425,16980205,8,0,0,2048,1,9948545672
2299,11814670,14378052,26192722,0,0,1,1024,8,6401935831
2300,11816890,4940811,16757701,0,0,0,52736,8,2755056966
2301,11819900,4877591,16697491,7,0,0,2048,21,1202675310
2302,11826329,14367703,26194032,1,0,1,9728,5,6790251292
2303,11829020,14390798,26219818,9,0,1,1024,4,6022357163
2304,11838020,4965265,16803285,8,0,0,1536,1,455170650
2305,11843649,14386059,26229708,1,0,1,3584,5,529234310
2306,11848760,5170585,17019345,7,0,0,7680,21,2449034070
2307,11849150,14415478,26264628,9,0,1,6656,4,6560154037
2308,11852200,14412451,26264651,0,0,1,4096,8,8065927542
2309,11852920,14411754,26264674,0,0,1,11776,8,8972699377
2310,11853540,5042334,16895874,7,0,0,27136,21,50317452
2311,11854430,4936186,16790616,7,0,0,25600,21,6055565228
2312,11857720,14498031,26355751,4,0,1,2048,25,5823351458
2313,11866330,14507851,26374181,9,0,1,4608,4,9463596440
2314,11874150,5131507,17005657,0,0,0,32256,8,1451352236
2315,11874899,14546357,26421256,1,0,1,10240,5,8748350420
2316,11879909,14704348,26584257,1,0,1,4608,5,6463506022
2317,11880140,5151125,17031265,7,0,0,15360,21,7976796273
2318,11880470,14703810,26584280,4,0,1,3072,25,4577925901
2319,11881840,5248723,17130563,0,0,0,69632,8,1284774218
2320,11891540,14737901,26629441,0,0,1,512,8,6818560251
2321,11895220,5361014,17256234,7,0,0,113152,21,3219268193
2322,11902160,5522352,17424512,0,0,0,43008,8,6959588881
2323,11902650,4942428,16845078,8,0,0,1024,1,4301754798
2324,11919769,5170841,17090610,4,0,0,22016,25,438380285
2325,11919880,4932194,16852074,8,0,0,512,1,3881117487
2326,11926390,5232544,17158934,8,0,0,2560,1,9849662632
2327,11928080,14701384,26629464,4,0,1,512,25,9904632069
2328,11929200,5081160,17010360,7,0,0,15360,21,817453107
2329,11929240,14700247,26629487,2,0,1,2560,19,6427851536
2330,11930430,5149982,17080412,7,0,0,3072,21,4919929530
2331,11944850,14684660,26629510,0,0,1,3072,8,8700243625
2332,11949680,14679853,26629533,0,0,1,6656,8,3243719415
2333,11951190,14678366,26629556,0,0,1,9216,8,1284956459
2334,11952479,5246145,17198624,4,0,0,5632,25,1491620264
2335,11959190,14671216,26630406,0,0,1,512,8,7867378485
2336,11959490,5431237,17390727,8,0,0,44032,1,8057870470
2337,11962040,14668389,26630429,0,0,1,6144,8,1515671853
2338,11968120,14670311,26638431,9,0,1,6144,4,4528911790
2339,11972330,5163895,17136225,7,0,0,18432,21,6160443723
2340,11974580,5284961,17259541,0,0,0,10752,8,297498803
2341,11977360,14671889,26649249,2,0,1,8704,19,8567049596
2342,11993470,14655882,26649352,2,0,1,3072,19,6199334634
2343,12003670,14645705,26649375,0,0,1,512,8,5467705431
2344,12006060,14683031,26689091,9,0,1,6144,4,1549877077
2345,12033530,5163355,17196885,8,0,0,95232,1,3892499652
2346,12034561,14655298,26689859,7,0,1,11776,21,6727274785
2347,12037150,14657535,26694685,2,0,1,7680,19,5093188235
2348,12041729,5607063,17648792,4,0,0,81920,25,8474596409
2349,12042209,5369176,17411385,4,0,0,16896,25,4593434047
2350,12042370,14687835,26730205,9,0,1,512,4,10299574289
2351,12042440,5526001,17568441,7,0,0,224768,21,6909418281
2352,12048530,5260783,17309313,0,0,0,16896,8,6632657400
2353,12058291,14671937,26730228,7,0,1,1536,21,6981904652
2354,12069700,14660559,26730259,2,0,1,5632,19,9530382455
2355,12070561,14733351,26803912,7,0,1,3072,21,421724062
2356,12071560,5517808,17589368,0,0,0,68608,8,300661554
2357,12073141,14792668,26865809,7,0,1,35328,21,1456687841
2358,12075380,5387847,17463227,8,0,0,8704,1,8154810728
2359,12078170,14787662,26865832,0,0,1,7680,8,5509492438
2360,12085660,14809257,26894917,0,0,1,4608,8,2311208899
2361,12094160,14800788,26894948,9,0,1,5120,4,9017147144
2362,12094210,5688264,17782474,0,0,0,61440,8,10694503697
2363,12102400,5303814,17406214,8,0,0,18944,1,8444208104
2364,12105770,14810320,26916090,9,0,1,7680,4,4331793479
2365,12107599,5858688,17966287,4,0,0,167936,25,8185802659
2366,12111880,5542707,17654587,0,0,0,18944,8,3570919398
2367,12119380,14829522,26948902,0,0,1,3584,8,4007557233
2368,12121140,14845904,26967044,9,0,1,16384,4,3644834106
2369,12144850,14822217,26967067,9,0,1,12288,4,9969183364
2370,12149500,14831861,26981361,2,0,1,3072,19,1242472205
2371,12150000,5448708,17598708,7,0,0,26624,21,7129744380
2372,12151410,14829974,26981384,9,0,1,12288,4,4747818561
2373,12152909,5516968,17669877,4,0,0,3584,25,485530465
2374,12154791,14894308,27049099,7,0,1,512,21,4499443180
2375,12156880,14892242,27049122,9,0,1,4096,4,1444088385
2376,12166270,14882875,27049145,2,0,1,512,19,8928130579
2377,12169390,14879778,27049168,9,0,1,10240,4,9259274947
2378,12170480,5488541,17659021,0,0,0,2048,8,7056204296
2379,12172200,14902028,27074228,2,0,1,5120,19,5293936898
2380,12180671,14933565,27114236,7,0,1,512,21,9195917401
2381,12181320,14933902,27115222,2,0,1,1536,19,9384938275
2382,12195230,14921298,27116528,0,0,1,2048,8,1891505596
2383,12195930,14922544,27118474,2,0,1,3072,19,1766055899
2384,12202180,5516601,17718781,7,0,0,36864,21,4554889718
2385,12222090,14902957,27125047,2,0,1,3072,19,10455138809
2386,12224010,14901060,27125070,2,0,1,2560,19,6085483980
2387,12228589,5617564,17846153,4,0,0,36864,25,2100075160
2388,12228821,5627411,17856232,2,0,0,2048,19,308173036
2389,12228970,14911698,27140668,9,0,1,1536,4,9801793529
2390,12229390,14914184,27143574,0,0,1,4608,8,1830000254
2391,12232590,14911548,27144138,2,0,1,10752,19,7507635130
2392,12233890,14911631,27145521,0,0,1,14848,8,6538697143
2393,12236590,5785420,18022010,8,0,0,17920,1,177265052
2394,12239100,14907407,27146507,0,0,1,1536,8,1686931581
2395,12243871,5888652,18132523,2,0,0,1024,19,8917990973
2396,12253410,14894083,27147493,9,0,1,1536,4,8598048276
2397,12253741,14907841,27161582,7,0,1,7168,21,4732676930
2398,12256200,14907167,27163367,3,0,1,4608,21,9308457479
2399,12263101,5643594,17906695,2,0,0,512,19,1422393357
2400,12264210,14899180,27163390,3,0,1,2048,21,937681453
2401,12265850,5894198,18160048,7,0,0,10752,21,9170596014
2402,12276020,5856168,18132188,7,0,0,151552,21,1103277926
2403,12290420,14872993,27163413,9,0,1,2560,4,1214296317
2404,12293140,5952519,18245659,0,0,0,48640,8,8514625607
2405,12297170,14889749,27186919,9,0,1,12288,4,5295465983
2406,12299880,14887705,27187585,2,0,1,1024,19,1013491673
2407,12306319,5994145,18300464,4,0,0,29696,25,8373419714
2408,12308411,5893207,18201618,2,0,0,512,19,2798811593
2409,12330360,5897980,18228340,0,0,0,54272,8,3358598455
2410,12331490,5840196,18171686,7,0,0,16384,21,3958662414
2411,12334421,14856070,27190491,7,0,1,4608,21,6793109286
2412,12343400,14855383,27198783,3,0,1,1536,21,1839892525
2413,12350930,14860038,27210968,2,0,1,2560,19,10678532398
2414,12351660,14860793,27212453,2,0,1,15360,19,5943674971
2415,12356180,6089926,18446106,7,0,0,13824,21,3325731341
2416,12364130,5970798,18334928,0,0,0,41984,8,1619223682
2417,12365300,6350281,18715581,0,0,0,178176,8,1248483099
2418,12366030,5845743,18211773,0,0,0,31744,8,3889187880
2419,12367400,5863216,18230616,0,0,0,7168,8,9786309380
2420,12370151,14858422,27228573,7,0,1,512,21,1287207298
2421,12371629,6075551,18447180,4,0,0,1536,25,2404274793
2422,12377430,14851489,27228919,9,0,1,512,4,3831305825
2423,12389060,6037995,18427055,0,0,0,66560,8,5909789899
2424,12390390,14841755,27232145,9,0,1,5120,4,10241814493
2425,12394110,14847140,27241250,9,0,1,2048,4,6456766799
2426,12395291,6050994,18446285,2,0,0,512,19,4114406299
2427,12397151,14847325,27244476,7,0,1,5120,21,764662074
2428,12397480,14865462,27262942,9,0,1,512,4,3659042928
2429,12398660,6128984,18527644,7,0,0,16384,21,3712054432
2430,12401340,6077284,18478624,7,0,0,11776,21,7472026027
2431,12401811,6143268,18545079,2,0,0,512,19,2530594711
2432,12419360,14843605,27262965,9,0,1,7168,4,6976560711
2433,12426081,14842234,27268315,7,0,1,3072,21,2412963866
2434,12438041,14830297,27268338,7,0,1,5632,21,3898860254
2435,12441831,5896053,18337884,2,0,0,2560,19,6570223890
2436,12453780,14834801,27288581,9,0,1,3584,4,8801539126
2437,12456550,14832054,27288604,9,0,1,3072,4,10673454151
2438,12480870,5827068,18307938,7,0,0,11264,21,5223672848
2439,12500761,14787866,27288627,7,0,1,2048,21,1825453298
2440,12501870,5983017,18484887,0,0,0,20480,8,10203079645
2441,12503250,6013734,18516984,8,0,0,53760,1,2863905041
2442,12504860,14783790,27288650,2,0,1,11776,19,4275144787
2443,12510610,14778063,27288673,9,0,1,2048,4,9502325690
2444,12512110,5922300,18434410,0,0,0,24064,8,2352218517
2445,12515411,14792945,27308356,7,0,1,12288,21,9136357158
2446,12521180,14791042,27312222,2,0,1,6144,19,7673596448
2447,12522490,14836387,27358877,9,0,1,4608,4,7024287337
2448,12522830,6396865,18919695,8,0,0,36864,1,9753632273
2449,12523160,14835740,27358900,2,0,1,7680,19,6569779105
2450,12533750,6004847,18538597,7,0,0,21504,21,341597806
2451,12534771,14824152,27358923,7,0,1,3072,21,2340749263
2452,12539860,6033594,18573454,8,0,0,27648,1,4872572967
2453,12543690,6089391,18633081,8,0,0,56320,1,5432461418
2454,12547151,6086109,18633260,2,0,0,512,19,1071214517
2455,12547579,14827134,27374713,8,0,1,3072,1,8648550539
2456,12548791,14867745,27416536,7,0,1,4608,21,4800239120
2457,12553530,6335961,18889491,0,0,0,48640,8,7087349249
2458,12553960,6177907,18731867,8,0,0,30720,1,1622393441
2459,12557940,6103330,18661270,8,0,0,18432,1,10282887488
2460,12558341,14858218,27416559,7,0,1,3072,21,3497381547
2461,12562841,14853741,27416582,7,0,1,1024,21,6747770371
2462,12562980,14869248,27432228,2,0,1,4608,19,8650301874
2463,12565910,14988337,27554247,2,0,1,3584,19,5566295331
2464,12570910,15021543,27592453,2,0,1,3072,19,5991858210
2465,12571530,15048228,27619758,0,0,1,4608,8,8860249830
2466,12585580,15037404,27622984,2,0,1,5120,19,8960119480
2467,12587529,15052975,27640504,8,0,1,6656,1,1717616362
2468,12588800,15080121,27668921,0,0,1,4096,8,1038768250
2469,12589349,15079828,27669177,8,0,1,9216,1,8136005656
2470,12590750,15145761,27736511,9,0,1,6656,4,3348414760
2471,12591071,6143683,18734754,2,0,0,1024,19,5393406973
2472,12592610,15154588,27747198,2,0,1,3584,19,4947619030
2473,12597460,15171959,27769419,2,0,1,6144,19,2501528377
2474,12609371,6315079,18924450,2,0,0,512,19,7860730589
2475,12609541,6507523,19117064,2,0,0,1024,19,8225912197
2476,12610140,6152157,18762297,8,0,0,20480,1,5871165998
2477,12610380,6033702,18644082,0,0,0,5632,8,7847987729
2478,12614760,15206152,27820912,0,0,1,1024,8,8840760657
2479,12614881,6117165,18732046,2,0,0,512,19,1281259798
2480,12625790,15197708,27823498,9,0,1,4096,4,9670549670
2481,12628409,6094067,18722476,4,0,0,22528,25,6238431979
2482,12654900,6250187,18905087,7,0,0,22528,21,1534439480
2483,12655790,15168694,27824484,0,0,1,1536,8,1029450679
2484,12658400,6565237,19223637,7,0,0,8704,21,8489604663
2485,12666590,15160800,27827390,0,0,1,4608,8,36923482
2486,12692301,6304000,18996301,2,0,0,1536,19,3755589833
2487,12693630,15136986,27830616,9,0,1,5120,4,745649696
2488,12694000,6154286,18848286,8,0,0,18432,1,525726607
2489,12694070,6373347,19067417,8,0,0,122880,1,6708085708
2490,12697690,6419039,19116729,7,0,0,88576,21,10228206412
2491,12697950,15134612,27832562,0,0,1,3072,8,5524008284
2492,12701759,15136500,27838259,8,0,1,18944,1,8298035914
2493,12703109,15203855,27906964,8,0,1,13824,1,493001212
2494,12706440,6274005,18980445,8,0,0,78848,1,4996062619
2495,12725040,15290172,28015212,2,0,1,5120,19,980735026
2496,12726029,15289206,28015235,1,0,1,3072,5,2288216646
2497,12735569,6186148,18921717,4,0,0,2048,25,7380845095
2498,12744629,6161773,18906402,4,0,0,512,25,928185859
2499,12756620,6239182,18995802,8,0,0,2048,1,1008988128
2500,12768180,6226975,18995155,8,0,0,38912,1,6535946055
2501,12769100,15295073,28064173,2,0,1,1024,19,628370483
2502,12780580,6249374,19029954,8,0,0,30720,1,1015818991
2503,12780959,15283237,28064196,1,0,1,1536,5,9332161575
2504,12781660,15282559,28064219,2,0,1,1536,19,3844441272
2505,12790290,6279178,19069468,0,0,0,6656,8,3338018961
2506,12803510,15260732,28064242,4,0,1,8704,25,3757126454
2507,12809310,15527334,28336644,6,0,1,40960,17,9833229639
2508,12821370,15577117,28398487,2,0,1,1536,19,3718210581
2509,12826890,15572263,28399153,2,0,1,1024,19,5435054126
2510,12839771,6277940,19117711,2,0,0,2048,19,8207932622
2511,12845400,6407743,19253143,8,0,0,72704,1,8790965294
2512,12846340,15579020,28425360,4,0,1,4096,25,1794440340
2513,12846530,15578853,28425383,2,0,1,512,19,9173769209
2514,12851730,6131546,18983276,7,0,0,9216,21,320128528
2515,12856640,15568774,28425414,2,0,1,11264,19,7656215414
2516,12866680,15558757,28425437,6,0,1,8704,17,1730169091
2517,12868680,15566701,28435381,3,0,1,2048,21,8179298081
2518,12872120,15598001,28470121,2,0,1,6144,19,1997839669
2519,12873740,15597252,28470992,2,0,1,12288,19,4568103363
2520,12879660,16075106,28954766,6,0,1,124928,17,9389332146
2521,12893490,6262287,19155777,8,0,0,19456,1,10649661189
2522,12894689,6367213,19261902,4,0,0,28672,25,590692627
2523,12898840,16055949,28954789,2,0,1,1536,19,7103601411
2524,12900830,7349496,20250326,8,0,0,117760,1,10561747998
2525,12905040,6370394,19275434,0,0,0,7168,8,3323645444
2526,12911211,16045184,28956395,7,0,1,7168,21,3445945678
2527,12916040,6654570,19570610,8,0,0,40960,1,2232329420
2528,12916651,6345898,19262549,2,0,0,2048,19,6257342401
2529,12917260,16216441,29133701,6,0,1,158720,17,1862527719
2530,12918460,16215264,29133724,2,0,1,9216,19,8650390018
2531,12935680,16350411,29286091,6,0,1,92160,17,3953557209
2532,12935820,6748957,19684777,7,0,0,138240,21,252506374
2533,12940479,6553180,19493659,4,0,0,33280,25,1789013503
2534,12940489,6606978,19547467,3,0,0,41472,21,6837319647
2535,12942910,6948249,19891159,7,0,0,9216,21,9493039072
2536,12946419,6752825,19699244,4,0,0,1024,25,2035659478
2537,12946460,16394782,29341242,6,0,1,40960,17,9738432739
2538,12948320,6553630,19501950,0,0,0,27136,8,2894846757
2539,12955040,6464326,19419366,7,0,0,2560,21,4931688505
2540,12974170,16367095,29341265,2,0,1,8192,19,9437234439
2541,12980610,16360686,29341296,2,0,1,3584,19,4323283793
2542,12982139,6432901,19415040,4,0,0,1536,25,7941667443
2543,12988711,16352608,29341319,7,0,1,3072,21,1999903918
2544,12988970,16352372,29341342,2,0,1,6144,19,10042376151
2545,12990260,16400703,29390963,2,0,1,20992,19,1087261448
2546,12996440,16395189,29391629,2,0,1,1024,19,3820007515
2547,13010480,6523595,19534075,0,0,0,12288,8,7899341399
2548,13010700,16385435,29396135,2,0,1,7168,19,3745508076
2549,13016620,16380181,29396801,2,0,1,1024,19,7335217339
2550,13018580,6678879,19697459,8,0,0,41472,1,2845353863
2551,13021030,16391126,29412156,3,0,1,4608,21,95022732
2552,13026040,16398174,29424214,3,0,1,3584,21,10006677097
2553,13032699,16391538,29424237,8,0,1,11776,1,1265406469
2554,13036880,16387380,29424260,3,0,1,3072,21,8719515390
2555,13036910,16387389,29424299,2,0,1,4096,19,1620525318
2556,13049259,6522154,19571413,4,0,0,2560,25,2622153890
2557,13055710,6686740,19742450,8,0,0,21504,1,6056652074
2558,13062880,16384720,29447600,6,0,1,75264,17,8180204905
2559,13064279,16433201,29497480,1,0,1,3584,5,7222540005
2560,13071081,16434097,29505178,7,0,1,6144,21,356138951
2561,13075091,16447492,29522583,7,0,1,2560,21,5821137318
2562,13078211,6622161,19700372,2,0,0,512,19,1196800451
2563,13083020,16450818,29533838,2,0,1,5632,19,7636999147
2564,13084350,16458271,29542621,3,0,1,4096,21,3741609823
2565,13087240,16458132,29545372,6,0,1,11776,17,7864229640
2566,13099980,16445738,29545718,0,0,1,512,8,4850283898
2567,13101549,6598442,19699991,4,0,0,2048,25,5653480368
2568,13102650,16448355,29551005,3,0,1,16896,21,8384309122
2569,13105910,16445441,29551351,3,0,1,512,21,6996577943
2570,13107750,6606091,19713841,0,0,0,26624,8,5238725633
2571,13115230,16452560,29567790,3,0,1,10752,21,9784203880
2572,13116160,16453573,29569733,3,0,1,14848,21,6868698947
2573,13126581,6793907,19920488,2,0,0,2560,19,953796134
2574,13134441,6459155,19593596,2,0,0,2560,19,6588629569
2575,13138521,6560388,19698909,2,0,0,1536,19,4494768888
2576,13140731,6559439,19700170,2,0,0,512,19,8937922140
2577,13152200,6600569,19752769,0,0,0,33792,8,4414309583
2578,13159450,16410744,29570194,2,0,1,10240,19,3657553183
2579,13160420,6636352,19796772,8,0,0,23552,1,8507809169
2580,13170160,6693039,19863199,8,0,0,9216,1,6645248473
2581,13195191,16375669,29570860,7,0,1,1024,21,3338842575
2582,13195301,6523802,19719103,2,0,0,512,19,6218861776
2583,13222650,6475768,19698418,8,0,0,3072,1,5346189066
2584,13226920,16440830,29667750,6,0,1,89088,17,2274156352
2585,13230060,6619984,19850044,0,0,0,33792,8,6821654740
2586,13236640,16431133,29667773,3,0,1,4096,21,8520450839
2587,13254360,16414863,29669223,3,0,1,17408,21,3738904086
2588,13255260,16438944,29694204,3,0,1,512,21,5607989316
2589,13255700,16450795,29706495,9,0,1,1024,4,745364510
2590,13258540,16461495,29720035,3,0,1,7680,21,4714405018
2591,13267069,6453420,19720489,4,0,0,1024,25,8460628793
2592,13276270,16448277,29724547,3,0,1,7168,21,7712953627
2593,13277920,16470848,29748768,9,0,1,4608,4,4604612207
2594,13280000,16468791,29748791,9,0,1,512,4,9145730060
2595,13291450,16457364,29748814,9,0,1,3072,4,9692769023
2596,13298170,16457048,29755218,3,0,1,5120,21,2749477701
2597,13299809,6587240,19887049,3,0,0,14336,21,3259191643
2598,13300160,6507937,19808097,8,0,0,512,1,2926656343
2599,13313930,16446473,29760403,6,0,1,24576,17,7924426892
2600,13352970,16444225,29797195,3,0,1,2560,21,1879525918
2601,13353109,6781499,20134608,4,0,0,2048,25,6970832626
2602,13355310,16443511,29798821,3,0,1,2560,21,8377248173
2603,13366260,16436427,29802687,4,0,1,6144,25,5215037156
2604,13371970,16435582,29807552,9,0,1,16896,4,391420146
2605,13375910,16437589,29813499,9,0,1,1024,4,4411456408
2606,13376640,6405326,19781966,0,0,0,18944,8,9199928938
2607,13377210,6583157,19960367,0,0,0,55808,8,986415306
2608,13379389,6496909,19876298,4,0,0,512,25,7957755237
2609,13387179,7020762,20407941,3,0,0,6656,21,5906278887
2610,13391759,6574582,19966341,3,0,0,14848,21,4443319851
2611,13402180,16414865,29817045,4,0,1,5632,25,444709631
2612,13405489,6533029,19938518,3,0,0,2560,21,6278764719
2613,13419499,7014560,20434059,4,0,0,512,25,3536966895
2614,13420250,16400661,29820911,3,0,1,6144,21,1726139823
2615,13424171,6362080,19786251,2,0,0,512,19,1368752730
2616,13425429,16402273,29827702,1,0,1,2048,5,7539029725
2617,13428091,6463255,19891346,2,0,0,512,19,3916488199
2618,13429550,16398818,29828368,4,0,1,1024,25,9812975543
2619,13431190,6646330,20077520,0,0,0,25600,8,5668182250
2620,13433590,16397364,29830954,3,0,1,4096,21,1280421167
2621,13438099,6695862,20133961,3,0,0,38912,21,415345245
2622,13438141,6728672,20166813,2,0,0,512,19,6981056910
2623,13438769,6566127,20004896,3,0,0,33280,21,8739826245
2624,13444580,16388320,29832900,4,0,1,3072,25,4246612157
2625,13445299,6690424,20135723,4,0,0,3584,25,9348461429
2626,13445300,16412100,29857400,3,0,1,15360,21,6375047205
2627,13445670,16411753,29857423,4,0,1,2048,25,542436191
2628,13448150,6513644,19961794,8,0,0,4608,1,7139769227
2629,13459579,6662503,20122082,3,0,0,22528,21,4199848135
2630,13462179,6543208,20005387,4,0,0,1536,25,8874133919
2631,13471549,6416771,19888320,4,0,0,4096,25,3596465297
2632,13478890,6529816,20008706,8,0,0,512,1,4292065514
2633,13481660,6774663,20256323,0,0,0,18944,8,3138144537
2634,13484150,6848717,20332867,0,0,0,29696,8,7023439118
2635,13487190,16370256,29857446,9,0,1,512,4,7521826304
2636,13494760,6588340,20083100,0,0,0,3584,8,7802460162
2637,13495630,16361839,29857469,3,0,1,3072,21,7268166210
2638,13496491,6754037,20250528,2,0,0,512,19,9219702029
2639,13497250,6669384,20166634,5,0,0,101376,25,10572219906
2640,13510111,6567673,20077784,2,0,0,512,19,6794942424
2641,13511591,6477569,19989160,2,0,0,1024,19,10630676417
2642,13514780,6670520,20185300,8,0,0,512,1,3014214108
2643,13527370,16332983,29860353,4,0,1,18432,25,9539480056
2644,13529550,16353961,29883511,9,0,1,18944,4,5440519096
2645,13529570,16371996,29901566,4,0,1,2560,25,7614326527
2646,13531000,16371552,29902552,9,0,1,1536,4,2997116693
2647,13532860,16373904,29906764,4,0,1,6656,25,9762190736
2648,13538930,16370100,29909030,4,0,1,3584,25,6373038909
2649,13543740,16368516,29912256,3,0,1,5120,21,36735709
2650,13544030,16371132,29915162,4,0,1,4608,25,8851049407
2651,13552529,6616420,20168949,3,0,0,6656,21,8017051310
2652,13560599,6806023,20366622,3,0,0,26624,21,694531576
2653,13560900,16354608,29915508,3,0,1,512,21,4112765224
2654,13568261,6755512,20323773,2,0,0,1024,19,434104166
2655,13568571,6536912,20105483,2,0,0,512,19,8583322439
2656,13569250,6754188,20323438,0,0,0,72704,8,4347053241
2657,13573671,6852544,20426215,2,0,0,512,19,8686066540
2658,13581890,16334284,29916174,4,0,1,1024,25,10411670683
2659,13584280,16333520,29917800,3,0,1,2560,21,5682404820
2660,13595989,6743165,20339154,4,0,0,1536,25,9505326520
2661,13596020,16366614,29962634,3,0,1,6144,21,3013987722
2662,13604220,16358445,29962665,9,0,1,14336,4,2053620951
2663,13605640,16357048,29962688,3,0,1,2048,21,4174628365
2664,13606170,16356541,29962711,9,0,1,5120,4,6607769576
2665,13612179,6813826,20426005,3,0,0,44544,21,5120680018
2666,13615251,16347483,29962734,5,0,1,6656,25,3322905622
2667,13625491,16337266,29962757,5,0,1,13312,25,2725422368
2668,13626141,16336639,29962780,5,0,1,3584,25,2232789074
2669,13640270,16322533,29962803,9,0,1,6144,4,2140484262
2670,13640880,16321946,29962826,4,0,1,512,25,8134597971
2671,13643630,16319219,29962849,9,0,1,2560,4,1737508570
2672,13660070,16302802,29962872,9,0,1,3584,4,505865632
2673,13665830,16297065,29962895,4,0,1,3072,25,1345750763
2674,13669839,6697274,20367113,4,0,0,1536,25,3082352609
2675,13671190,16291728,29962918,9,0,1,1536,4,1604210510
2676,13674800,6710437,20385237,8,0,0,1024,1,475736273
2677,13676189,16286752,29962941,8,0,1,1024,1,9020516837
2678,13676610,6922453,20599063,0,0,0,44544,8,7658907941
2679,13685720,6647372,20333092,8,0,0,512,1,1599909275
2680,13686611,6721509,20408120,2,0,0,512,19,2024021463
2681,13688209,6695243,20383452,4,0,0,5120,25,547587647
2682,13697570,16265394,29962964,9,0,1,512,4,9701547286
2683,13701620,6572633,20274253,8,0,0,512,1,1227705113
2684,13703609,16264349,29967958,8,0,1,4096,1,1893079573
2685,13706811,6744181,20450992,2,0,0,512,19,10259294542
2686,13716121,6694868,20410989,2,0,0,1536,19,2405634548
2687,13722420,16251279,29973699,4,0,1,5632,25,1991281883
2688,13726069,16249896,29975965,8,0,1,3584,1,519066148
2689,13728701,16247930,29976631,5,0,1,1024,25,4351410777
2690,13733010,16244607,29977617,2,0,1,1536,19,3246356811
2691,13740000,16246924,29986924,9,0,1,5632,4,3338220424
2692,13742710,6761447,20504157,8,0,0,512,1,5134369097
2693,13761710,16230911,29992621,9,0,1,27136,4,1168199050
2694,13764390,16240382,30004772,9,0,1,4096,4,9978688977
2695,13776890,16228868,30005758,4,0,1,1536,25,6181879279
2696,13779010,6605245,20384255,0,0,0,2560,8,9407203643
2697,13781350,6957553,20738903,0,0,0,79360,8,6863667188
2698,13784150,16223874,30008024,2,0,1,3584,19,6707876158
2699,13785529,6583589,20369118,4,0,0,4096,25,1494109346
2700,13786960,16239300,30026260,2,0,1,1024,19,7746319770
2701,13793879,6645320,20439199,4,0,0,1024,25,6013073014
2702,13803030,6721619,20524649,0,0,0,2560,8,3939352243
2703,13807919,6906781,20714700,4,0,0,3072,25,10563362691
2704,13811791,6824004,20635795,2,0,0,1536,19,6146446457
2705,13813099,16216430,30029529,8,0,1,1024,1,10190637565
2706,13821889,16211826,30033715,8,0,1,6656,1,2972282746
2707,13823669,6890072,20713741,3,0,0,57856,21,3055161474
2708,13824330,16209846,30034176,4,0,1,10240,25,10186427951
2709,13836009,16199793,30035802,1,0,1,2560,5,5041507062
2710,13838750,16197308,30036058,4,0,1,9216,25,9544263939
2711,13849639,16200201,30049840,8,0,1,1536,1,5070978553
2712,13856850,16193656,30050506,9,0,1,1024,4,7831899944
2713,13859460,16232715,30092175,2,0,1,2560,19,366043645
2714,13864139,6603362,20467501,3,0,0,2048,21,2067873908
2715,13864310,16228211,30092521,2,0,1,512,19,3318122031
2716,13865470,16227689,30093159,4,0,1,512,25,6624379080
2717,13866439,7104868,20971307,4,0,0,2048,25,4085644920
2718,13871501,6778795,20650296,2,0,0,512,19,5966291201
2719,13888810,16216272,30105082,2,0,1,14848,19,9885203631
2720,13896031,6568652,20464683,2,0,0,512,19,3088958882
2721,13896699,6974591,20871290,3,0,0,8192,21,8063405701
2722,13902680,16213297,30115977,9,0,1,1536,4,7890893617
2723,13906750,6833657,20740407,8,0,0,512,1,9619737758
2724,13913640,6826588,20740228,0,0,0,2560,8,2668723157
2725,13918160,16215762,30133922,2,0,1,5120,19,2506499621
2726,13929780,16204165,30133945,2,0,1,2048,19,7594112724
2727,13947609,6679510,20627119,4,0,0,1536,25,619937720
2728,13953529,6735693,20689222,4,0,0,512,25,9602381525
2729,13980279,16153689,30133968,8,0,1,7168,1,2340676729
2730,13981340,7436399,21417739,0,0,0,70656,8,1253480145
2731,13982610,6957338,20939948,8,0,0,512,1,8264715904
2732,13991211,16142780,30133991,5,0,1,2048,25,10163093968
2733,13991950,16142064,30134014,9,0,1,1536,4,6844252587
2734,13997921,6665896,20663817,2,0,0,512,19,4033233438
2735,13998270,16158123,30156393,3,0,1,12800,21,376270023
2736,14014230,16142936,30157166,4,0,1,4096,25,9394453884
2737,14019260,16141418,30160678,2,0,1,5632,19,7814214944
2738,14025219,16136125,30161344,8,0,1,1024,1,9367340673
2739,14027639,6648689,20676328,4,0,0,512,25,9056094451
2740,14039319,16129016,30168335,8,0,1,4096,1,1918062204
2741,14039760,16133081,30172841,2,0,1,7168,19,1042972332
2742,14043019,16171282,30214301,8,0,1,7168,1,8639062365
2743,14044639,6864757,20909396,3,0,0,7168,21,3459136287
2744,14044669,7095913,21140582,3,0,0,4608,21,2065960499
2745,14063160,6946850,21010010,0,0,0,99328,8,6596088303
2746,14070611,16144356,30214967,5,0,1,1024,25,6224478100
2747,14070970,6986784,21057754,0,0,0,34816,8,4718055042
2748,14077590,16138043,30215633,2,0,1,1024,19,4281735266
2749,14079180,6755459,20834639,0,0,0,10240,8,1644489054
2750,14082690,6656392,20739082,1,0,0,512,5,1970395354
2751,14096931,16122568,30219499,5,0,1,6144,25,7510672849
2752,14108460,6630965,20739425,8,0,0,1024,1,6754887301
2753,14110069,7901126,22011195,4,0,0,26624,25,9382360849
2754,14110969,7227206,21338175,3,0,0,83968,21,7629111762
2755,14116249,16106476,30222725,8,0,1,5120,1,6317393852
2756,14118619,16105732,30224351,8,0,1,2560,1,4046061862
2757,14123121,16101486,30224607,5,0,1,9216,25,8976059224
2758,14128981,16113281,30242262,7,0,1,10240,21,6358870688
2759,14141670,16100615,30242285,4,0,1,2560,25,425167785
2760,14144701,6807988,20952689,2,0,0,512,19,4914850010
2761,14145940,7282269,21428209,0,0,0,3072,8,3089232937
2762,14147169,16095139,30242308,8,0,1,512,1,589981034
2763,14159780,6669425,20829205,8,0,0,1024,1,4190901180
2764,14164970,16078466,30243436,4,0,1,2048,25,1106663095
2765,14201120,7505299,21706419,0,0,0,49152,8,3916050373
2766,14202531,16043811,30246342,5,0,1,4608,25,2475059397
2767,14207360,6770480,20977840,8,0,0,512,1,1396970685
2768,14209769,7086414,21296183,4,0,0,273408,25,4266789367
2769,14212339,6693279,20905618,3,0,0,1536,21,620867764
2770,14215400,16032248,30247648,4,0,1,2048,25,9157044687
2771,14219639,6886985,21106624,3,0,0,512,21,10605783596
2772,14220280,16028341,30248621,4,0,1,12800,25,9000417359
2773,14221890,7804731,22026621,8,0,0,512,1,1475689261
2774,14222259,7090130,21312389,4,0,0,1024,25,9898483431
2775,14223141,16203019,30426160,7,0,1,18944,21,6853963434
2776,14239080,6771733,21010813,8,0,0,2560,1,2517246659
2777,14240000,16302218,30542218,4,0,1,8704,25,2465778927
2778,14241521,16301683,30543204,7,0,1,1536,21,8229528741
2779,14249671,16294199,30543870,5,0,1,1024,25,7927071470
2780,14254040,16295962,30550002,4,0,1,9728,25,10562434000
2781,14255021,16295327,30550348,7,0,1,512,21,3694569695
2782,14257741,16294233,30551974,5,0,1,2560,25,10593621392
2783,14267371,6826276,21093647,2,0,0,512,19,8923960640
2784,14267589,6838856,21106445,4,0,0,17920,25,3391408600
2785,14270919,7032197,21303116,3,0,0,22528,21,9963465115
2786,14275659,16277941,30553600,8,0,1,2560,1,2781760642
2787,14278681,16278145,30556826,7,0,1,5120,21,1727507093
2788,14293510,16320311,30613821,4,0,1,1536,25,9400872984
2789,14294509,6826119,21120628,3,0,0,2048,21,6262420737
2790,14310239,16303605,30613844,8,0,1,1024,1,10019870654
2791,14311520,16302347,30613867,3,0,1,14336,21,7758322767
2792,14313130,6832155,21145285,0,0,0,15360,8,3604102518
2793,14319020,16301919,30620939,3,0,1,12800,21,1884776664
2794,14330970,7041783,21372753,0,0,0,113152,8,6353828995
2795,14334810,6977758,21312568,8,0,0,512,1,9881053158
2796,14335829,6976225,21312054,4,0,0,29184,25,2579375943
2797,14339600,7078613,21418213,8,0,0,512,1,7916215581
2798,14340501,16326243,30666744,5,0,1,6656,25,4298382995
2799,14345110,7027978,21373088,8,0,0,1024,1,2456028140
2800,14345709,7030990,21376699,4,0,0,11776,25,4430019521
2801,14355019,16312391,30667410,8,0,1,1024,1,5396571997
2802,14355041,16313995,30669036,5,0,1,2560,25,1192046035
2803,14360101,16310881,30670982,5,0,1,3072,25,9931288466
2804,14362321,16309647,30671968,5,0,1,1536,25,2054816738
2805,14362509,16310445,30672954,8,0,1,1536,1,9456325843
2806,14372700,16353021,30725721,2,0,1,2560,19,3690943964
2807,14374299,7013538,21387837,4,0,0,36352,25,7293129410
2808,14375070,16350682,30725752,2,0,1,3584,19,6031974625
2809,14375779,16353843,30729622,8,0,1,2560,1,7242454120
2810,14381250,16349358,30730608,3,0,1,1536,21,2692643299
2811,14382160,16351674,30733834,3,0,1,5120,21,9621585678
2812,14384029,7328520,21712549,3,0,0,19456,21,2906815692
2813,14385381,16349577,30734958,5,0,1,1536,25,3034029423
2814,14387541,16348403,30735944,7,0,1,1536,21,4397214214
2815,14392509,16450503,30843012,8,0,1,26112,1,9805485589
2816,14396901,16446134,30843035,5,0,1,3072,25,7478868264
2817,14406920,16436138,30843058,2,0,1,6144,19,6730585659
2818,14412030,16469801,30881831,2,0,1,1536,19,5581236858
2819,14419150,16462728,30881878,2,0,1,2560,19,5714713078
2820,14423011,16458890,30881901,7,0,1,2048,21,10429549721
2821,14425049,7242511,21667560,4,0,0,164352,25,8053917130
2822,14429030,16452894,30881924,2,0,1,512,19,7797327185
2823,14438700,7231320,21670020,0,0,0,4096,8,5689105338
2824,14442200,7285504,21727704,0,0,0,12288,8,10291259481
2825,14450490,7256108,21706598,8,0,0,512,1,2309689784
2826,14462321,7206428,21668749,2,0,0,1536,19,10087361673
2827,14465720,16416235,30881955,3,0,1,3584,21,7738383907
2828,14471729,16410249,30881978,8,0,1,512,1,2632730502
2829,14473379,7143205,21616584,3,0,0,4608,21,8141445120
2830,14482110,16399891,30882001,3,0,1,3072,21,8114258671
2831,14490191,16391833,30882024,5,0,1,1024,25,2982291199
2832,14507470,16442872,30950342,3,0,1,20992,21,4389802568
2833,14509629,16440736,30950365,8,0,1,4608,1,4227056937
2834,14520750,16429638,30950388,2,0,1,512,19,9058897790
2835,14523999,7429162,21953161,3,0,0,8704,21,9408960725
2836,14534059,7299958,21834017,3,0,0,25088,21,6644218036
2837,14534180,16416231,30950411,2,0,1,3584,19,1857397373
2838,14534930,7291420,21826350,0,0,0,56320,8,5335733707
2839,14538580,7669432,22208012,0,0,0,28672,8,7236027345
2840,14543351,16407083,30950434,5,0,1,10752,25,7818034069
2841,14543620,7216544,21760164,0,0,0,1536,8,4011919575
2842,14545371,7137402,21682773,2,0,0,1024,19,2215715680
2843,14551430,16401234,30952664,2,0,1,2048,19,9850198731
2844,14554789,7393022,21947811,4,0,0,40448,25,2667650232
2845,14556170,7329751,21885921,0,0,0,14848,8,7701662508
2846,14566419,7231640,21798059,3,0,0,26624,21,5361451885
2847,14566510,16386512,30953022,2,0,1,7168,19,7720481262
2848,14571030,16389378,30960408,2,0,1,2560,19,3475759551
2849,14576470,16383961,30960431,2,0,1,3072,19,6333538100
2850,14582469,16378033,30960502,8,0,1,6144,1,1475974680
2851,14582470,16378055,30960525,3,0,1,2048,21,10713180214
2852,14585740,7082449,21668189,8,0,0,1536,1,2806268015
2853,14601481,7301590,21903071,2,0,0,1024,19,4443977122
2854,14603780,16357727,30961507,3,0,1,5120,21,5174126833
2855,14606171,7164865,21771036,2,0,0,1024,19,3127266136
2856,14614280,16347250,30961530,3,0,1,9728,21,4909112191
2857,14620239,7367075,21987314,4,0,0,8192,25,1628798879
2858,14622510,16359138,30981648,2,0,1,7168,19,8911100999
2859,14623310,16358940,30982250,3,0,1,1536,21,1164286966
2860,14628851,7601116,22229967,2,0,0,1536,19,7849882171
2861,14655281,7559664,22214945,2,0,0,512,19,8521826152
2862,14658620,7556146,22214766,0,0,0,21504,8,3861972435
2863,14660550,16321723,30982273,2,0,1,7168,19,10612272966
2864,14663041,7306721,21969762,2,0,0,2048,19,2670172796
2865,14663900,16318396,30982296,3,0,1,10752,21,5268359842
2866,14665109,16319641,30984750,8,0,1,2048,1,8229944317
2867,14669381,16357672,31027053,5,0,1,2560,25,940582442
2868,14670150,16357249,31027399,3,0,1,512,21,8946950675
2869,14676950,7522303,22199253,0,0,0,259584,8,7579210589
2870,14682090,7245930,21928020,8,0,0,2048,1,7975046878
2871,14684419,7545057,22229476,4,0,0,47616,25,1730587142
2872,14689609,16338456,31028065,8,0,1,1024,1,2010920959
2873,14696570,16347959,31044529,2,0,1,1024,19,9964313633
2874,14696800,7253686,21950486,0,0,0,8704,8,4096181344
2875,14709400,16365194,31074594,3,0,1,6144,21,9760417943
2876,14716231,7398131,22114362,2,0,0,512,19,8956215182
2877,14716519,16360112,31076631,8,0,1,512,1,1209879765
2878,14717650,7370831,22088481,0,0,0,57344,8,2875419938
2879,14718010,16360106,31078116,2,0,1,15360,19,6465724442
2880,14722130,7327469,22049599,8,0,0,512,1,805631982
2881,14729249,7680963,22410212,3,0,0,157184,21,9607187639
2882,14732350,7066067,21798417,8,0,0,1024,1,7704360449
2883,14733839,16350635,31084474,8,0,1,1536,1,1201024835
2884,14736960,7471231,22208191,8,0,0,512,1,7780821108
2885,14747680,7486857,22234537,0,0,0,2560,8,191857924
2886,14763959,16322141,31086100,8,0,1,2560,1,768952162
2887,14765020,16331045,31096065,2,0,1,2560,19,5808793206
2888,14774690,16322041,31096731,2,0,1,1024,19,6160309059
2889,14775450,16322907,31098357,3,0,1,2560,21,3855798876
2890,14779190,16319513,31098703,3,0,1,512,21,3388453677
2891,14788460,16311549,31100009,0,0,1,2048,8,5215055854
2892,14798459,7465038,22263497,4,0,0,81408,25,5789557779
2893,14803120,7221965,22025085,8,0,0,512,1,9957560880
2894,14804290,16296065,31100355,2,0,1,512,19,6777552114
2895,14812710,7204699,22017409,8,0,0,512,1,1711013300
2896,14814591,7449397,22263988,2,0,0,1536,19,3446907527
2897,14818080,16283043,31101123,2,0,1,11776,19,8439310585
2898,14818830,16284239,31103069,3,0,1,3072,21,428963026
2899,14832329,7529968,22362297,3,0,0,23040,21,6115428631
2900,14838530,16264885,31103415,0,0,1,512,8,748785195
2901,14861969,7430333,22292302,3,0,0,92160,21,924578666
2902,14866040,7372599,22238639,6,0,0,13312,17,2346058006
2903,14869260,7546113,22415373,0,0,0,512,8,52569373
2904,14873620,7360114,22233734,6,0,0,12288,17,2021568123
2905,14876761,7387438,22264199,2,0,0,512,19,4363103819
2906,14890870,16216091,31106961,3,0,1,5632,21,7252314664
2907,14892481,7577579,22470060,2,0,0,2560,19,6274372619
2908,14893029,7571190,22464219,4,0,0,99328,25,6558724223
2909,14897060,16220330,31117390,0,0,1,1024,8,3108186655
2910,14903411,7389124,22292535,2,0,0,512,19,1095011421
2911,14916990,16204906,31121896,0,0,1,7168,8,10222678006
2912,14937239,7531995,22469234,4,0,0,16384,25,1375058583
2913,14939370,16183832,31123202,0,0,1,2048,8,5539055741
2914,14946100,7630175,22576275,6,0,0,36352,17,441164273
2915,14946830,7368380,22315210,6,0,0,28672,17,1651559346
2916,14948739,16178995,31127734,8,0,1,7168,1,5030014899
2917,14948769,7640474,22589243,4,0,0,5632,25,9420705035
2918,14949840,7521824,22471664,0,0,0,3584,8,5224631274
2919,14950319,7605450,22555769,4,0,0,20992,25,2145982342
2920,14954080,7456646,22410726,0,0,0,1536,8,8288671571
2921,14960909,7454216,22415125,3,0,0,14336,21,6230090551
2922,14963220,7807067,22770287,6,0,0,116736,17,5173404077
2923,14968650,7501883,22470533,0,0,0,1024,8,8820548855
2924,14975609,7814293,22789902,3,0,0,45056,21,8299908683
2925,14977139,7699437,22676576,4,0,0,41984,25,10661385661
2926,14981020,7434532,22415552,0,0,0,512,8,9255896124
2927,14982030,16154664,31136694,0,0,1,10752,8,5898429267
2928,14982320,7791734,22774054,6,0,0,12288,17,1409061333
2929,14983670,7563602,22547272,8,0,0,512,1,9193732762
2930,14990849,16187549,31178398,8,0,1,23040,1,2516922646
2931,14992480,16187224,31179704,0,0,1,2048,8,1474455950
2932,14995161,16188089,31183250,7,0,1,5632,21,1454119678
2933,15000119,16189410,31189529,8,0,1,6144,1,6417879548
2934,15003440,7821883,22825323,8,0,0,3072,1,6861264761
2935,15020870,16169632,31190502,0,0,1,12800,8,2276864215
2936,15023329,7821467,22844796,3,0,0,10752,21,2470080239
2937,15028709,7620186,22648895,3,0,0,88576,21,7006516563
2938,15032140,7446820,22478960,0,0,0,2560,8,6640227815
2939,15033941,7471317,22505258,2,0,0,2048,19,8678367204
2940,15041780,16158704,31200484,2,0,1,512,19,7324942747
2941,15049530,7740738,22790268,0,0,0,1024,8,921873313
2942,15050810,16154180,31204990,2,0,1,7168,19,4315329659
2943,15055700,16149956,31205656,3,0,1,11264,21,3691847625
2944,15060070,16146841,31206911,2,0,1,1024,19,6396501296
2945,15067089,16140386,31207475,8,0,1,10752,1,9273577159
2946,15069999,7889757,22959756,3,0,0,27648,21,2190454375
2947,15074869,8237087,23311956,4,0,0,29696,25,3022834043
2948,15075699,7726548,22802247,3,0,0,7680,21,7642729976
2949,15076829,7791079,22867908,4,0,0,10240,25,813660860
2950,15081579,16147245,31228824,8,0,1,11264,1,3870834238
2951,15083880,8441767,23525647,6,0,0,147456,17,6453604102
2952,15087929,7770654,22858583,4,0,0,30208,25,8146799925
2953,15089371,7998494,23087865,2,0,0,2048,19,9185906135
2954,15092690,7714938,22807628,6,0,0,1024,17,3389285914
2955,15096280,16202051,31298331,2,0,1,19968,19,5470398909
2956,15097451,16202744,31300195,5,0,1,7168,25,10167154439
2957,15102040,16200101,31302141,2,0,1,3072,19,6293412033
2958,15105379,7694505,22799884,4,0,0,31232,25,6468744457
2959,15106750,7542324,22649074,0,0,0,512,8,1033966325
2960,15113510,8028832,23142342,6,0,0,28672,17,8116822114
2961,15115720,16186767,31302487,0,0,1,512,8,8715261218
2962,15117341,8306202,23423543,2,0,0,512,19,10723779764
2963,15118389,7657092,22775481,4,0,0,4608,25,5670160958
2964,15121901,7591594,22713495,2,0,0,512,19,8187442210
2965,15126471,8476915,23603386,2,0,0,1536,19,4516774687
2966,15139930,7840723,22980653,8,0,0,1024,1,1065177093
2967,15150220,7844561,22994781,6,0,0,16384,17,4939285416
2968,15161120,7718097,22879217,0,0,0,1024,8,8384897584
2969,15162140,7613832,22775972,0,0,0,1536,8,758862466
2970,15162859,16148306,31311165,8,0,1,3072,1,4463102855
2971,15164379,8258985,23423364,4,0,0,6656,25,5392700601
2972,15167260,16143928,31311188,2,0,1,3584,19,4185411255
2973,15170540,7561916,22732456,0,0,0,512,8,6835304772
2974,15191069,7745134,22936203,4,0,0,22528,25,4110727249
2975,15192490,7818694,23011184,6,0,0,53760,17,2821958484
2976,15194640,8199858,23394498,8,0,0,1024,1,7741452533
2977,15203709,7871454,23075163,4,0,0,52224,25,1795342780
2978,15212641,16098570,31311211,7,0,1,6656,21,9072038619
2979,15214189,7808420,23022609,3,0,0,29696,21,5459802957
2980,15214280,16099831,31314111,2,0,1,5120,19,2125184446
2981,15219419,16128305,31347724,8,0,1,5632,1,4403285660
2982,15223491,16237094,31460585,5,0,1,2048,25,2464906892
2983,15230260,7884059,23114319,8,0,0,2048,1,3780738766
2984,15230999,16230572,31461571,8,0,1,1536,1,10269792333
2985,15238271,16223646,31461917,7,0,1,512,21,9428009164
2986,15241840,16221703,31463543,2,0,1,2560,19,10089384379
2987,15244051,7681139,22925190,2,0,0,512,19,3164309919
2988,15245890,7996370,23242260,8,0,0,19456,1,1110982555
2989,15247279,8047631,23294910,4,0,0,4608,25,4157721778
2990,15253509,8283260,23536769,4,0,0,30720,25,3677616047
2991,15254560,16213489,31468049,9,0,1,7168,4,4477638698
2992,15258940,8100386,23359326,8,0,0,49664,1,8608720738
2993,15262320,7513831,22776151,0,0,0,512,8,373646680
2994,15264251,16204259,31468510,5,0,1,10240,25,1464239723
2995,15266000,7555885,22821885,0,0,0,1024,8,9352697799
2996,15272351,16248120,31520471,5,0,1,6144,25,13975168
2997,15273881,7627026,22900907,2,0,0,512,19,8158496819
2998,15282681,16237893,31520574,7,0,1,1024,21,10517839287
2999,15284399,8108824,23393223,4,0,0,51200,25,8603198485
3000,15285449,16236431,31521880,8,0,1,2048,1,10500723437
3001,15289250,7833277,23122527,0,0,0,512,8,4172199605
3002,15303441,16222446,31525887,5,0,1,15872,25,4753177610
3003,15317840,7764813,23082653,8,0,0,20992,1,3474208994
3004,15320509,16207324,31527833,8,0,1,3072,1,6667758796
3005,15322280,7893139,23215419,8,0,0,14336,1,6213621063
3006,15323659,8273707,23597366,4,0,0,73216,25,2513905371
3007,15326591,16208353,31534944,5,0,1,3072,25,7469424604
3008,15335959,8295116,23631075,3,0,0,71680,21,9458667879
3009,15339080,16197297,31536377,2,0,1,3072,19,6659008646
3010,15349039,7773309,23122348,3,0,0,22016,21,2151214673
3011,15357639,16180684,31538323,8,0,1,3072,1,8373313775
3012,15376259,16163690,31539949,8,0,1,2560,1,1627344610
3013,15381449,8382657,23764106,4,0,0,117248,25,9098973544
3014,15390301,16152554,31542855,5,0,1,4608,25,3275153326
3015,15395789,8205188,23600977,3,0,0,11776,21,3578468506
3016,15396381,7809891,23206272,2,0,0,1024,19,10383526211
3017,15397090,7801059,23198149,0,0,0,512,8,3830669784
3018,15397209,8163763,23560972,4,0,0,79360,25,5418136177
3019,15409499,16208573,31618072,8,0,1,4608,1,189050671
3020,15418399,8294657,23713056,4,0,0,87040,25,6215742492
3021,15424111,16194163,31618274,5,0,1,512,25,4032979052
3022,15426129,16192168,31618297,8,0,1,10240,1,4064470613
3023,15428909,8023246,23452155,3,0,0,7680,21,1088736872
3024,15434769,16183551,31618320,8,0,1,2048,1,2130879872
3025,15448329,16170014,31618343,8,0,1,16896,1,6443042746
3026,15449989,8523532,23973521,4,0,0,96768,25,5582783408
3027,15455559,8403758,23859317,4,0,0,16384,25,5771985340
3028,15462060,16156306,31618366,9,0,1,3584,4,8669593958
3029,15473619,16144770,31618389,8,0,1,10752,1,6384986711
3030,15505760,7666569,23172329,0,0,0,512,8,4385995533
3031,15507570,7742981,23250551,6,0,0,27136,17,3544639729
3032,15522450,8713674,24236124,6,0,0,51712,17,10169590457
3033,15524700,8189681,23714381,0,0,0,4096,8,4882039849
3034,15532539,8076673,23609212,3,0,0,7680,21,2448358801
3035,15547921,8503393,24051314,2,0,0,23552,19,10039489281
3036,15550869,16112980,31663849,8,0,1,28160,1,4408234610
3037,15553209,8021826,23575035,3,0,0,46080,21,2413817029
3038,15560979,8114953,23675932,4,0,0,68096,25,5046851064
3039,15575909,8249955,23825864,4,0,0,54272,25,5271573072
3040,15587080,8345614,23932694,6,0,0,30720,17,3070522431
3041,15587251,7940135,23527386,2,0,0,5632,19,2265612078
3042,15588589,8018252,23606841,4,0,0,11264,25,512305025
3043,15596591,8817103,24413694,2,0,0,144384,19,7437707430
3044,15599051,7766538,23365589,2,0,0,20480,19,740161252
3045,15606720,7728048,23334768,6,0,0,32256,17,306947864
3046,15639470,8543473,24182943,0,0,0,512,8,1043315104
3047,15650210,8357792,24008002,6,0,0,101888,17,2520716539
3048,15676159,7978971,23655130,4,0,0,78848,25,7754143188
3049,15681099,8823981,24505080,3,0,0,4608,21,7663166686
3050,15692019,16026614,31718633,1,0,1,11776,5,3013083115
3051,15709199,7977291,23686490,4,0,0,32256,25,6445511406
3052,15713011,8052678,23765689,2,0,0,5120,19,2918923313
3053,15722751,16018746,31741497,5,0,1,6144,25,7123205711
3054,15731109,7871763,23602872,3,0,0,6144,21,3675258907
3055,15737011,16059464,31796475,5,0,1,4096,25,4335338255
3056,15738730,8464718,24203448,0,0,0,1536,8,2552556925
3057,15744410,8582298,24326708,6,0,0,90112,17,6173655067
3058,15750691,16069609,31820300,5,0,1,10240,25,8071232570
3059,15766720,7909391,23676111,0,0,0,512,8,2548385687
3060,15768880,8085422,23854302,6,0,0,87552,17,330317364
3061,15772059,16049341,31821400,1,0,1,512,5,66485675
3062,15780719,16044573,31825292,1,0,1,6144,5,3486529564
3063,15786470,16057021,31843491,2,0,1,1536,19,3381563934
3064,15793791,8183098,23976889,2,0,0,10752,19,9739483428
3065,15796480,8225716,24022196,0,0,0,512,8,8368083136
3066,15815459,8675210,24490669,3,0,0,111104,21,9667540934
3067,15825780,8037378,23863158,6,0,0,2560,17,5222035335
3068,15861079,8563870,24424949,3,0,0,36864,21,8511735749
3069,15861550,15981964,31843514,2,0,1,3072,19,8940654319
3070,15863630,15979907,31843537,2,0,1,4608,19,8644941426
3071,15875239,7952364,23827603,4,0,0,5632,25,7322712493
3072,15880350,15963210,31843560,2,0,1,1024,19,197685917
3073,15881179,8226450,24107629,3,0,0,35328,21,6100616746
3074,15886370,8278212,24164582,6,0,0,10752,17,9974270938
3075,15886981,8789767,24676748,2,0,0,41472,19,1147998293
3076,15898760,8439636,24338396,6,0,0,1024,17,755327130
3077,15941009,8349609,24290618,3,0,0,118272,21,5198413917
3078,15950940,8540647,24491587,0,0,0,512,8,6454777848
3079,15952849,8250108,24202957,4,0,0,9216,25,7156261505
3080,15953770,8671748,24625518,0,0,0,512,8,8202968549
3081,15966319,8791523,24757842,3,0,0,75264,21,5996704719
3082,15972980,15870603,31843583,2,0,1,5120,19,2002481953
3083,15973710,15870231,31843941,2,0,1,1536,19,4708126264
3084,15975420,8370284,24345704,0,0,0,512,8,3847303255
3085,15978089,7917730,23895819,4,0,0,20480,25,7567123878
3086,15984480,8520935,24505415,0,0,0,1024,8,3664285644
3087,15985080,8571381,24556461,6,0,0,134144,17,7966006208
3088,15992110,8739923,24732033,6,0,0,88064,17,3822576160
3089,15999850,8597174,24597024,6,0,0,46592,17,9512224882
3090,16000510,8298711,24299221,6,0,0,28160,17,3952941256
3091,16006250,15837714,31843964,2,0,1,1024,19,10040134124
3092,16009709,8765495,24775204,3,0,0,55296,21,3045395615
3093,16020599,15823388,31843987,8,0,1,3072,1,2437712670
3094,16027231,8550001,24577232,2,0,0,68096,19,8607225668
3095,16030420,8571683,24602103,0,0,0,512,8,5089768372
3096,16042530,15810138,31852668,2,0,1,3072,19,3457495244
3097,16043499,8787949,24831448,4,0,0,1024,25,10529072807
3098,16045899,8647700,24693599,4,0,0,49664,25,2245056712
3099,16057060,15812686,31869746,4,0,1,4096,25,9935323497
3100,16058340,8058236,24116576,0,0,0,512,8,4046100177
3101,16060111,15815844,31875955,5,0,1,21504,25,10674504392
3102,16065009,7994908,24059917,4,0,0,28160,25,3821019973
3103,16071139,15846900,31918039,8,0,1,4096,1,9966196407
3104,16094010,15888972,31982982,6,0,1,31744,17,2835583911
3105,16098740,8904552,25003292,6,0,0,94208,17,1011141543
3106,16099220,8357574,24456794,0,0,0,1024,8,1723976774
3107,16109339,9084811,25194150,3,0,0,153088,21,3174690225
3108,16112360,15870645,31983005,2,0,1,3584,19,3899430767
3109,16123930,15869521,31993451,2,0,1,16896,19,6577375298
3110,16131820,8696650,24828470,6,0,0,30720,17,9084091602
3111,16136930,8928351,25065281,6,0,0,30720,17,4854651079
3112,16143261,8997570,25140831,2,0,0,155136,19,6099921370
3113,16144000,8191168,24335168,0,0,0,512,8,1021340563
3114,16147241,9328576,25475817,2,0,0,23040,19,2892052676
3115,16157081,8333923,24491004,2,0,0,1024,19,5080124287
3116,16164740,15868780,32033520,2,0,1,2048,19,706301573
3117,16165750,15867793,32033543,2,0,1,512,19,1451051124
3118,16172249,9217630,25389879,3,0,0,79872,21,1166689218
3119,16178019,8313389,24491408,4,0,0,512,25,669330720
3120,16193190,15845703,32038893,2,0,1,5632,19,3397124472
3121,16193529,8465834,24659363,3,0,0,53248,21,9713045127
3122,16195609,8745201,24940810,3,0,0,26112,21,8706808189
3123,16199010,8127885,24326895,0,0,0,512,8,632513199
3124,16205410,8597330,24802740,6,0,0,74240,17,6028618528
3125,16207160,8416962,24624122,0,0,0,512,8,1839579916
3126,16208460,15832507,32040967,2,0,1,18432,19,3273917020
3127,16208780,8305057,24513837,0,0,0,2048,8,1389048889
3128,16209410,8548923,24758333,6,0,0,1536,17,3695908588
3129,16216991,15823999,32040990,7,0,1,5632,21,9570355550
3130,16217009,9442474,25659483,4,0,0,105472,25,511114155
3131,16223680,8267549,24491229,0,0,0,512,8,7485444666
3132,16224021,15828451,32052472,7,0,1,7168,21,9541152802
3133,16237001,15824632,32061633,7,0,1,3072,21,9120866552
3134,16239820,8357383,24597203,0,0,0,512,8,7909503885
3135,16242021,8183271,24425292,2,0,0,1024,19,9788898881
3136,16256111,8478441,24734552,2,0,0,8192,19,5355278957
3137,16260590,15801405,32061995,2,0,1,512,19,1914513909
3138,16262160,15801781,32063941,2,0,1,3072,19,6158467069
3139,16271110,15795737,32066847,0,0,1,4608,8,10617504237
3140,16272761,15818479,32091240,7,0,1,16896,21,3070034220
3141,16275001,8388753,24663754,2,0,0,14336,19,10379744309
3142,16275480,8388609,24664089,0,0,0,1024,8,4149634725
3143,16279651,15814201,32093852,7,0,1,4096,21,870380826
3144,16281451,15892483,32173934,7,0,1,1536,21,6237586318
3145,16285161,8449726,24734887,2,0,0,1024,19,583965339
3146,16288090,8607750,24895840,0,0,0,1024,8,2925181754
3147,16300361,8916680,25217041,2,0,0,6144,19,2014436847
3148,16301859,8910410,25212269,4,0,0,59392,25,5532140337
3149,16302339,8563043,24865382,3,0,0,40960,21,10024394469
3150,16306779,8596202,24902981,4,0,0,14336,25,2564972438
3151,16307120,15866837,32173957,0,0,1,5120,8,5940804258
3152,16310690,15863290,32173980,4,0,1,3584,25,4734096429
3153,16319061,15855433,32174494,7,0,1,7168,21,5119080638
3154,16321560,15852957,32174517,0,0,1,4608,8,31739843
3155,16323249,8624625,24947874,3,0,0,22016,21,2313111074
3156,16327080,9462602,25789682,6,0,0,47616,17,3265871456
3157,16329880,15844660,32174540,2,0,1,1024,19,6435786122
3158,16332581,15841982,32174563,7,0,1,7680,21,5985262283
3159,16337910,15895135,32233045,0,0,1,2048,8,5409308584
3160,16347809,9013799,25361608,3,0,0,10752,21,8317721018
3161,16361379,9475025,25836404,4,0,0,54784,25,5689847269
3162,16383291,9549800,25933091,2,0,0,27136,19,898337745
3163,16384599,9630431,26015030,4,0,0,3584,25,1822938545
3164,16390431,15842637,32233068,5,0,1,1536,25,8405095666
3165,16400470,15832621,32233091,9,0,1,2048,4,1808157526
3166,16411941,8735542,25147483,2,0,0,13312,19,10655145389
3167,16444711,8461725,24906436,2,0,0,11264,19,6876265017
3168,16449189,9770606,26219795,4,0,0,84480,25,8933284100
3169,16452539,9777138,26229677,3,0,0,32256,21,8296955802
3170,16469631,9112497,25582128,2,0,0,8704,19,941597790
3171,16470869,8557938,25028807,4,0,0,12800,25,9274036070
3172,16486410,8606004,25092414,6,0,0,19968,17,5302063209
3173,16496420,8644590,25141010,0,0,0,512,8,1770696379
3174,16500809,8728032,25228841,3,0,0,11776,21,3847221978
3175,16512301,9843419,26355720,2,0,0,126976,19,5483780837
3176,16516189,8834434,25350623,3,0,0,25600,21,10592618543
3177,16533709,8856973,25390682,4,0,0,2560,25,9221938395
3178,16546029,8762330,25308359,3,0,0,91648,21,8279868012
3179,16554490,9150155,25704645,0,0,0,512,8,6865125361
3180,16571041,8705093,25276134,2,0,0,1024,19,8520695809
3181,16573959,8651092,25225051,4,0,0,25088,25,501411675
3182,16575019,8639613,25214632,3,0,0,7680,21,481236599
3183,16587410,8637820,25225230,0,0,0,512,8,10611839342
3184,16589130,8625993,25215123,0,0,0,1536,8,1498974958
3185,16594610,8622766,25217376,0,0,0,1024,8,9220032031
3186,16609861,9073651,25683512,2,0,0,26624,19,5440300810
3187,16625859,8716918,25342777,3,0,0,25600,21,7368890710
3188,16626479,8952974,25579453,3,0,0,51712,21,5240824136
3189,16628711,8729598,25358309,2,0,0,25088,19,1619335852
3190,16637450,10080229,26717679,6,0,0,42496,17,2863493339
3191,16647431,9990977,26638408,2,0,0,26112,19,3154476244
3192,16673871,8640595,25314466,2,0,0,19968,19,6442894242
3193,16682689,10121200,26803889,3,0,0,4608,21,8222251962
3194,16688731,9853828,26542559,2,0,0,138752,19,8310918925
3195,16699700,8568303,25268003,0,0,0,2048,8,1946184913
3196,16700290,10159967,26860257,6,0,0,93696,17,10470089765
3197,16701061,9234549,25935610,2,0,0,8192,19,1675779921
3198,16704990,10206237,26911227,6,0,0,48128,17,7925843664
3199,16717119,9956340,26673459,3,0,0,34304,21,2206691936
3200,16723310,9760213,26483523,6,0,0,63488,17,1233092932
3201,16725651,9873004,26598655,2,0,0,47104,19,251490059
3202,16734140,9582869,26317009,6,0,0,101888,17,8187971273
3203,16734839,15498275,32233114,1,0,1,9216,5,1193824224
3204,16748049,9071640,25819689,4,0,0,8192,25,4424685943
3205,16752061,9367743,26119804,2,0,0,42496,19,5919397178
3206,16760449,9056629,25817078,3,0,0,26624,21,8559249062
3207,16789729,9362719,26152448,3,0,0,76800,21,9200198802
3208,16791710,15441443,32233153,0,0,1,512,8,3787760683
3209,16791939,10095288,26887227,4,0,0,70144,25,7010996399
3210,16810680,15423523,32234203,0,0,1,13312,8,3001621988
3211,16812500,9189005,26001505,6,0,0,7168,17,10168996471
3212,16814650,15424036,32238686,0,0,1,9216,8,5148136755
3213,16821630,15418042,32239672,9,0,1,1536,4,7331514143
3214,16821890,8852927,25674817,6,0,0,50176,17,1260168803
3215,16828499,8915402,25743901,3,0,0,6144,21,2218682206
3216,16853040,15389858,32242898,0,0,1,5120,8,8446791374
3217,16856730,15398256,32254986,0,0,1,3584,8,5491569954
3218,16862030,8855237,25717267,0,0,0,512,8,2117588289
3219,16869840,9814422,26684262,6,0,0,35328,17,6181431886
3220,16871209,9007494,25878703,4,0,0,18944,25,6791083316
3221,16873639,8810052,25683691,4,0,0,512,25,10334242089
3222,16876679,9387926,26264605,4,0,0,73216,25,10208346486
3223,16883649,15378233,32261882,1,0,1,1024,5,8669976181
3224,16889461,8692846,25582307,2,0,0,512,19,1711716694
3225,16893001,15369169,32262170,5,0,1,3072,25,4800834368
3226,16896841,10084497,26981338,2,0,0,44032,19,3716143232
3227,16899261,9749965,26649226,2,0,0,35328,19,432860987
3228,16909920,8971493,25881413,0,0,0,1024,8,9813763783
3229,16913550,9854374,26767924,0,0,0,512,8,5280053750
3230,16915649,9888754,26804403,4,0,0,1536,25,2369220712
3231,16919760,9441006,26360766,6,0,0,16384,17,1921513686
3232,16919900,8755477,25675377,6,0,0,1536,17,7518079223
3233,16933060,10116016,27049076,0,0,0,512,8,754577351
3234,16940059,9425098,26365157,4,0,0,14336,25,1657347332
3235,16941000,9043438,25984438,6,0,0,45056,17,1739754989
3236,16944549,9124952,26069501,3,0,0,32768,21,4809917640
3237,16971151,10013358,26984509,2,0,0,9216,19,395675050
3238,16981399,15282077,32263476,1,0,1,2048,5,6609359411
3239,16983889,10099450,27083339,3,0,0,29696,21,10017391845
3240,16984009,15280031,32264040,1,0,1,10752,5,2410277669
3241,17004509,15312593,32317102,1,0,1,6144,5,6628479705
3242,17005529,15311596,32317125,1,0,1,6144,5,7358231925
3243,17008889,8981190,25990079,3,0,0,8704,21,687808221
3244,17009010,9620408,26629418,0,0,0,100864,8,3981730180
3245,17022649,15294499,32317148,1,0,1,2048,5,10698513908
3246,17028751,9165242,26193993,2,0,0,4096,19,9125542243
3247,17035011,10090013,27125024,2,0,0,20480,19,2925715115
3248,17039209,10124135,27163344,3,0,0,1536,21,3391689373
3249,17040670,8955204,25995874,6,0,0,18944,17,6735220562
3250,17043449,15273722,32317171,1,0,1,2560,5,5779691214
3251,17053400,9187875,26241275,6,0,0,37888,17,791114029
3252,17065439,8951492,26016931,3,0,0,1536,21,10392516435
3253,17069569,10362636,27432205,4,0,0,51200,25,6590097028
3254,17069940,10066210,27136150,6,0,0,17408,17,3031189675
3255,17072630,10468935,27541565,6,0,0,110080,17,9760867156
3256,17075410,9006547,26081957,5,0,0,6656,25,4290609359
3257,17075489,9031344,26106833,4,0,0,34304,25,1307701256
3258,17089839,15227355,32317194,1,0,1,1024,5,8488627396
3259,17094919,15222298,32317217,1,0,1,15360,5,4240346613
3260,17095209,9147041,26242250,4,0,0,3072,25,2121307476
3261,17098319,15269280,32367599,1,0,1,3584,5,3083318587
3262,17112180,9384678,26496858,0,0,0,19968,8,9202061623
3263,17140840,9051859,26192699,6,0,0,27648,17,6769791443
3264,17161681,9640773,26802454,2,0,0,106496,19,9019463683
3265,17166811,10192043,27358854,2,0,0,120832,19,3400243824
3266,17172419,15196665,32369084,1,0,1,15360,5,947413784
3267,17173500,9651144,26824644,0,0,0,46592,8,8463609933
3268,17186120,9544062,26730182,0,0,0,40960,8,9408254191
3269,17189159,15370181,32559340,1,0,1,3584,5,851248160
3270,17189351,9236472,26425823,2,0,0,4096,19,4887611153
3271,17202800,15381779,32584579,0,0,1,5632,8,3292189141
3272,17209750,9205189,26414939,6,0,0,8704,17,9689333501
3273,17216760,9550985,26767745,6,0,0,108544,17,1000849946
3274,17231689,15352913,32584602,1,0,1,512,5,2455349695
3275,17233131,15351494,32584625,7,0,1,512,21,1092790173
3276,17234930,9732091,26967021,0,0,0,59392,8,8672740580
3277,17237199,9873402,27110601,3,0,0,29184,21,1865076949
3278,17247909,10347568,27595477,3,0,0,8704,21,5857590746
3279,17268560,15318919,32587479,9,0,1,16384,4,10088988364
3280,17269510,15317992,32587502,9,0,1,2048,4,1212336138
3281,17270239,15317286,32587525,1,0,1,2560,5,10707377461
3282,17270601,9313633,26584234,2,0,0,136704,19,1635730967
3283,17273710,15313838,32587548,9,0,1,512,4,2076914175
3284,17282421,9487562,26769983,2,0,0,6656,19,4049875620
3285,17283490,9581493,26864983,6,0,0,4096,17,4314448100
3286,17294190,15293381,32587571,0,0,1,5632,8,7884202459
3287,17296471,9438179,26734650,2,0,0,14336,19,1030711828
3288,17304300,9326059,26630359,0,0,0,2560,8,7031150211
3289,17310360,15277242,32587602,9,0,1,1536,4,3265367569
3290,17310860,10197134,27507994,0,0,0,77824,8,9391492529
3291,17320750,15266875,32587625,9,0,1,10240,4,3640855006
3292,17321601,9573293,26894894,2,0,0,25088,19,3601493555
3293,17329270,9619609,26948879,6,0,0,57856,17,5452183664
3294,17338149,9662763,27000912,4,0,0,53760,25,3390733718
3295,17342420,15245228,32587648,0,0,1,512,8,9453559862
3296,17342650,15245045,32587695,0,0,1,5632,8,9106079633
3297,17344231,15243487,32587718,7,0,1,1536,21,3063327932
3298,17353240,15254336,32607576,0,0,1,4096,8,5722320181
3299,17353280,15272674,32625954,3,0,1,4096,21,5507005857
3300,17356500,15351802,32708302,2,0,1,512,19,5783072583
3301,17359601,15348724,32708325,7,0,1,13824,21,3761949699
3302,17360340,15355249,32715589,9,0,1,512,4,6925718959
3303,17364960,15350975,32715935,9,0,1,512,4,7126310286
3304,17365490,9897429,27262919,0,0,0,59904,8,7335428039
3305,17367040,15349881,32716921,3,0,1,1536,21,6819027194
3306,17367800,15349467,32717267,3,0,1,512,21,3169158783
3307,17371221,15346712,32717933,7,0,1,1024,21,3229134452
3308,17372759,15347760,32720519,1,0,1,4096,5,8985254145
3309,17373309,15351076,32724385,1,0,1,6144,5,1012534378
3310,17385829,15346959,32732788,1,0,1,3584,5,5135056340
3311,17388121,15367782,32755903,5,0,1,5120,25,1637288105
3312,17389181,9646098,27035279,2,0,0,112640,19,356464101
3313,17396340,15362377,32758717,0,0,1,1024,8,8495595986
3314,17399040,15363223,32762263,2,0,1,5632,19,7517783790
3315,17400210,15400541,32800751,0,0,1,2560,8,6883105633
3316,17400329,9656038,27056367,4,0,0,23552,25,5987047579
3317,17402340,10184268,27586608,0,0,0,52736,8,4565028689
3318,17404199,9508775,26912974,3,0,0,5632,21,2765591273
3319,17404680,15396737,32801417,2,0,1,1024,19,8263706913
3320,17412461,15391862,32804323,7,0,1,4608,21,9374255722
3321,17415191,15398886,32814077,7,0,1,3584,21,483673780
3322,17417301,15404293,32821594,7,0,1,7168,21,6004471631
3323,17421349,15451333,32872682,1,0,1,4096,5,409429062
3324,17430580,15502187,32932767,9,0,1,9728,4,5655781254
3325,17431199,15529423,32960622,1,0,1,5120,5,5819055665
3326,17431290,15532605,32963895,4,0,1,5120,25,737637713
3327,17431310,15537731,32969041,0,0,1,8192,8,561076163
3328,17435580,15536042,32971622,9,0,1,11264,4,5679535413
3329,17442629,15558647,33001276,1,0,1,512,5,1457189607
3330,17446990,15554309,33001299,0,0,1,512,8,2741517265
3331,17449380,10121137,27570517,6,0,0,37888,17,162707678
3332,17457490,9406222,26863712,6,0,0,11264,17,1985276718
3333,17465871,15535451,33001322,7,0,1,512,21,2235506418
3334,17472910,15528435,33001345,9,0,1,3584,4,603291049
3335,17486181,15521714,33007895,7,0,1,8192,21,7095981872
3336,17490500,15518701,33009201,4,0,1,2048,25,3833643434
3337,17493811,9578343,27072154,2,0,0,51712,19,985674830
3338,17501730,15509737,33011467,0,0,1,3584,8,3790621453
3339,17510370,15503043,33013413,9,0,1,3072,4,2680105165
3340,17510740,15505579,33016319,2,0,1,4608,19,8749776993
3341,17512650,9535444,27048094,6,0,0,41984,17,1114474255
3342,17525219,10233702,27758921,4,0,0,38400,25,9125875909
3343,17529169,15488136,33017305,1,0,1,1536,5,3144805780
3344,17542041,9506856,27048897,2,0,0,2560,19,991897030
3345,17542111,9545791,27087902,2,0,0,14848,19,5238004996
3346,17554410,15467415,33021825,0,0,1,6656,8,5119174131
3347,17556579,10474895,28031474,3,0,0,45568,21,2904625636
3348,17559481,15463112,33022593,7,0,1,11776,21,1872934044
3349,17567469,9506736,27074205,3,0,0,6656,21,2411772010
3350,17570879,9294907,26865786,3,0,0,2560,21,7790716118
3351,17579339,15463729,33043068,1,0,1,3072,5,3216299619
3352,17588910,15455464,33044374,0,0,1,2048,8,6619186776
3353,17598230,15454376,33052606,2,0,1,1024,19,1993219670
3354,17603350,15451202,33054552,2,0,1,3072,19,2626113526
3355,17628051,15428767,33056818,7,0,1,3584,21,1673072288
3356,17636940,15422464,33059404,0,0,1,4096,8,7699404027
3357,17649239,9639319,27288558,4,0,0,57344,25,4559770858
3358,17650511,15409239,33059750,7,0,1,512,21,2734217513
3359,17650549,9511010,27161559,3,0,0,33792,21,9294230546
3360,17651501,15433638,33085139,7,0,1,5632,21,2120422836
3361,17652731,15433714,33086445,7,0,1,2048,21,6812334399
3362,17655971,15430833,33086804,7,0,1,9728,21,3204841027
3363,17662981,9535763,27198744,2,0,0,26624,19,4334644846
3364,17670521,15416629,33087150,7,0,1,512,21,6828019259
3365,17670541,15418235,33088776,7,0,1,2560,21,7678214899
3366,17672741,15501902,33174643,7,0,1,1536,21,9304454003
3367,17684789,9413330,27098119,4,0,0,27136,25,8905524324
3368,17694620,9757432,27452052,6,0,0,15872,17,10366230516
3369,17726101,15448565,33174666,7,0,1,5120,21,9824792392
3370,17727310,9689203,27416513,6,0,0,36352,17,4274811855
3371,17737309,9982596,27719905,3,0,0,37888,21,7591053801
3372,17739440,15435428,33174868,0,0,1,19968,8,1205816822
3373,17743661,15431230,33174891,7,0,1,24576,21,5338176325
3374,17744089,15518106,33262195,1,0,1,19456,5,7357104544
3375,17749201,9519091,27268292,2,0,0,17408,19,1659537035
3376,17749441,15558443,33307884,7,0,1,22016,21,4200004248
3377,17764989,9719270,27484259,4,0,0,30720,25,3167156506
3378,17777040,15535468,33312508,0,0,1,512,8,10387114372
3379,17778541,15533990,33312531,7,0,1,1024,21,2349637231
3380,17779630,15532924,33312554,0,0,1,6144,8,8028076050
3381,17779920,9672467,27452387,6,0,0,1024,17,8351807464
3382,17784771,10123152,27907923,2,0,0,3072,19,2417448433
3383,17788170,15524407,33312577,6,0,1,8704,17,5785629268
3384,17789009,15528357,33317366,1,0,1,8192,5,6543483296
3385,17790670,9372183,27162853,6,0,0,4096,17,9112556709
3386,17791739,15541429,33333168,1,0,1,1024,5,6143743413
3387,17792699,15540492,33333191,1,0,1,8704,5,8505919612
3388,17804200,15529046,33333246,2,0,1,3584,19,3099704252
3389,17811571,15521698,33333269,7,0,1,1024,21,5999653556
3390,17812829,15520463,33333292,1,0,1,1024,5,6930880577
3391,17813659,15519656,33333315,1,0,1,4096,5,9295349978
3392,17813751,9842164,27655915,2,0,0,46592,19,6387035271
3393,17815160,15543067,33358227,0,0,1,6656,8,1094284321
3394,17831031,10063228,27894259,2,0,0,99840,19,6957272443
3395,17833279,15524971,33358250,1,0,1,2560,5,4583966862
3396,17841939,15516334,33358273,1,0,1,4096,5,2239297562
3397,17842420,10172769,28015189,6,0,0,102400,17,5525880034
3398,17851629,15521336,33372965,1,0,1,6144,5,309156603
3399,17859559,9780922,27640481,3,0,0,44544,21,9524597291
3400,17863540,15526323,33389863,2,0,1,6656,19,3836931246
3401,17869741,15531491,33401232,7,0,1,4608,21,4802059691
3402,17871059,9716664,27587723,4,0,0,3584,25,8914641594
3403,17878349,9680601,27558950,4,0,0,15360,25,1088242002
3404,17889819,9841030,27730849,4,0,0,34304,25,5248876409
3405,17894310,15507268,33401578,0,0,1,512,8,2573416997
3406,17901291,9868105,27769396,2,0,0,34304,19,2138132258
3407,17913140,15705217,33618357,6,0,1,135168,17,4302615024
3408,17913640,15791072,33704712,3,0,1,13824,21,8799910244
3409,17919001,10041011,27960012,2,0,0,42496,19,9584612712
3410,17920690,15784045,33704735,0,0,1,5120,8,3244327848
3411,17936201,15769087,33705288,7,0,1,3584,21,6997472753
3412,17936481,15790975,33727456,7,0,1,2048,21,4311215185
3413,17938379,15789743,33728122,1,0,1,1024,5,2634458213
3414,17942211,15786897,33729108,7,0,1,1536,21,3191512826
3415,17945249,9608975,27554224,3,0,0,41472,21,5162968635
3416,17957289,15775711,33733000,1,0,1,6144,5,9011430745
3417,17960959,10464378,28425337,3,0,0,56320,21,8054017940
3418,17961891,9730759,27692650,2,0,0,65024,19,8181093434
3419,17963431,15773115,33736546,7,0,1,5632,21,6728638790
3420,17972219,15766273,33738492,1,0,1,3072,5,584246299
3421,17986869,9760306,27747175,3,0,0,21504,21,1562292154
3422,17988849,15769058,33757907,1,0,1,5632,5,139218869
3423,18003211,9854051,27857262,2,0,0,18944,19,5222337385
3424,18007269,9908797,27916066,4,0,0,26624,25,6271394451
3425,18040430,15760371,33800801,0,0,1,7680,8,7466587772
3426,18044400,15756424,33800824,9,0,1,512,4,5010200801
3427,18048739,9687749,27736488,3,0,0,18432,21,113092284
3428,18053949,9851877,27905826,3,0,0,37888,21,8109130187
3429,18055619,15745228,33800847,1,0,1,512,5,27039608
3430,18062359,9876886,27939245,4,0,0,12800,25,10595745356
3431,18066401,10073682,28140083,2,0,0,14848,19,609907918
3432,18074209,15726661,33800870,1,0,1,10240,5,669554868
3433,18082379,15748820,33831199,1,0,1,2560,5,9276101988
3434,18091541,10108611,28200152,2,0,0,43520,19,7666118601
3435,18102750,9746861,27849611,5,0,0,2048,25,961095275
3436,18102959,9743652,27846611,3,0,0,17408,21,3173266792
3437,18120119,9944031,28064150,4,0,0,23040,25,10375294095
3438,18121619,10035229,28156848,3,0,0,10752,21,9663054726
3439,18131789,15699441,33831230,1,0,1,3584,5,4665952171
3440,18141850,9632280,27774130,5,0,0,15360,25,9397935197
3441,18158230,10109656,28267886,5,0,0,2560,25,545053978
3442,18185860,15645393,33831253,9,0,1,10240,4,6662377938
3443,18188201,10094233,28282434,2,0,0,23552,19,9221095247
3444,18198841,15632435,33831276,5,0,1,2560,25,2240292957
3445,18202319,10318516,28520835,4,0,0,72192,25,2671813784
3446,18204940,9702001,27906941,6,0,0,3584,17,1138024416
3447,18230350,10057099,28287449,6,0,0,16384,17,5391465164
3448,18234400,15602681,33837081,0,0,1,11264,8,8704918227
3449,18234459,15605848,33840307,1,0,1,5120,5,397366127
3450,18237300,9728819,27966119,5,0,0,19968,25,8204138020
3451,18238100,10098521,28336621,5,0,0,97280,25,3236351794
3452,18238131,15602522,33840653,5,0,1,512,25,1937727390
3453,18240281,10167873,28408154,2,0,0,14336,19,120755076
3454,18240761,9894775,28135536,2,0,0,51712,19,9640782225
3455,18241291,15599708,33840999,5,0,1,512,25,6064553908
3456,18241439,10437632,28679071,4,0,0,151040,25,10278245538
3457,18252029,15594116,33846145,1,0,1,8192,5,8256155654
3458,18265770,15605001,33870771,4,0,1,3584,25,2512616351
3459,18276620,15596693,33873313,4,0,1,1024,25,6202003175
3460,18279650,9925985,28205635,6,0,0,17920,17,2681514791
3461,18288639,9823889,28112528,4,0,0,14336,25,3172133579
3462,18298030,10501467,28799497,5,0,0,46080,25,5230925188
3463,18303969,15569367,33873336,1,0,1,1536,5,7637007679
3464,18314910,15558449,33873359,4,0,1,3072,25,1329487971
3465,18321261,15559922,33881183,5,0,1,3584,25,8531244728
3466,18329020,9818582,28147602,5,0,0,24576,25,6476301832
3467,18330409,10624334,28954743,4,0,0,188416,25,8520456104
3468,18331161,15575307,33906468,5,0,1,512,25,5487384215
3469,18334899,10161234,28496133,3,0,0,81920,21,2423676643
3470,18336270,15570221,33906491,4,0,1,28672,25,1336254563
3471,18336591,15570258,33906849,5,0,1,7168,25,2296889162
3472,18345680,10264454,28610134,6,0,0,86528,17,1768876029
3473,18354751,15557162,33911913,5,0,1,25088,25,9823444
3474,18368101,15551710,33919811,5,0,1,1536,25,1120871646
3475,18369650,15550507,33920157,3,0,1,512,21,1739493182
3476,18374749,10124067,28498816,4,0,0,8704,25,4073309841
3477,18377281,15545462,33922743,5,0,1,4096,25,8494355096
3478,18388849,10611958,29000807,3,0,0,58880,21,1030483790
3479,18395091,15543814,33938905,5,0,1,7680,25,5961619479
3480,18431470,10259971,28691441,5,0,0,31232,25,7342141164
3481,18455940,10441372,28897312,5,0,0,174080,25,7768139811
3482,18476409,9957931,28434340,4,0,0,19968,25,3861459479
3483,18478191,15470077,33948268,5,0,1,8704,25,6413863055
3484,18479579,15470635,33950214,8,0,1,3072,1,8694909410
3485,18486661,9917102,28403763,2,0,0,11776,19,2777622075
3486,18495019,10525779,29020798,4,0,0,65536,25,2070088509
3487,18500739,15450141,33950880,8,0,1,1024,1,3405399805
3488,18502740,15452966,33955706,4,0,1,7680,25,2941561997
3489,18508199,15447853,33956052,8,0,1,512,1,7742135767
3490,18509059,15449259,33958318,8,0,1,3584,1,5358922
3491,18509600,10602192,29111792,5,0,0,86016,25,3762372412
3492,18510809,10472027,28982836,4,0,0,18944,25,41466514
3493,18513449,10069745,28583194,4,0,0,23040,25,4069154098
3494,18514069,15458541,33972610,1,0,1,7680,5,8049138372
3495,18527949,10243434,28771383,3,0,0,29184,21,494261243
3496,18530169,15445204,33975373,1,0,1,12800,5,7129693539
3497,18531969,9741755,28273724,3,0,0,10752,21,9130234945
3498,18538779,15462393,34001172,8,0,1,14848,1,9929963349
3499,18540430,15496092,34036522,4,0,1,13824,25,4125262854
3500,18550391,9842982,28393373,2,0,0,1536,19,10298532446
3501,18552249,15484939,34037188,8,0,1,1024,1,1692120815
3502,18553140,9686480,28239620,5,0,0,9728,25,3702834244
3503,18554729,9824688,28379417,3,0,0,6144,21,3161893984
3504,18566040,15590285,34156325,4,0,1,65536,25,1923850895
3505,18569410,15640587,34209997,4,0,1,54784,25,2430045858
3506,18588409,15624418,34212827,1,0,1,3584,5,447811405
3507,18589359,10478023,29067382,4,0,0,5120,25,4820111495
3508,18590680,9799021,28389701,5,0,0,4608,25,6493447030
3509,18591550,15624866,34216416,4,0,1,2048,25,9584059451
3510,18595479,10149642,28745121,3,0,0,58368,21,2433299823
3511,18600329,15617393,34217722,8,0,1,2048,1,3077451478
3512,18602340,15625106,34227446,4,0,1,15872,25,1691721218
3513,18603470,10628198,29231668,5,0,0,24064,25,5220395138
3514,18615739,15613653,34229392,1,0,1,3072,5,7264048586
3515,18615861,10211061,28826922,2,0,0,35328,19,7085193965
3516,18622759,9904503,28527262,3,0,0,20992,21,10551923219
3517,18630300,15681850,34312150,4,0,1,99328,25,7857965618
3518,18630869,10082021,28712890,3,0,0,28672,21,2604566057
3519,18633010,15698183,34331193,4,0,1,18944,25,6956633977
3520,18633819,15699640,34333459,8,0,1,3584,1,7098222084
3521,18634599,15701220,34335819,1,0,1,8704,5,4066265048
3522,18644989,10117471,28762460,3,0,0,56832,21,9708352213
3523,18663640,10541555,29205195,5,0,0,234496,25,7135878682
3524,18666850,15728470,34395320,4,0,1,77312,25,5423821661
3525,18669579,15728967,34398546,8,0,1,5120,1,7859042777
3526,18673510,10460168,29133678,5,0,0,57344,25,5629682258
3527,18678741,10298292,28977033,2,0,0,50688,19,1934501942
3528,18678909,15720303,34399212,1,0,1,1024,5,7350546308
3529,18693790,15716688,34410478,4,0,1,7168,25,6661075667
3530,18708669,15706677,34415346,8,0,1,4096,1,7089025106
3531,18731709,15685583,34417292,1,0,1,3072,5,1532093356
3532,18737860,10316008,29053868,5,0,0,23552,25,1721872425
3533,18742599,15680514,34423113,1,0,1,1024,5,6985834845
3534,18746620,10472826,29219446,5,0,0,46592,25,9426229759
3535,18750359,15680629,34430988,1,0,1,3584,5,8830557123
3536,18752669,15680585,34433254,1,0,1,3584,5,3882592964
3537,18755699,15686501,34442200,1,0,1,3584,5,65121975
3538,18756769,10026899,28783668,4,0,0,16384,25,10536446460
3539,18758289,10653844,29412133,4,0,0,45056,25,865993373
3540,18758539,9923363,28681902,3,0,0,9216,21,8466147686
3541,18759169,15683377,34442546,8,0,1,512,1,2595926388
3542,18767720,15679972,34447692,4,0,1,8192,25,2805170663
3543,18771870,15704232,34476102,4,0,1,52224,25,6241099216
3544,18781980,15699988,34481968,4,0,1,12800,25,2904463841
3545,18797840,15712090,34509930,9,0,1,9216,4,4313977141
3546,18800169,15713627,34513796,8,0,1,6144,1,6624301075
3547,18802260,10538959,29341219,5,0,0,72704,25,1559679048
3548,18805819,10155747,28961566,3,0,0,16896,21,6996374570
3549,18813349,10143023,28956372,4,0,0,5120,25,2656845788
3550,18818119,15697303,34515422,8,0,1,2560,1,7762306367
3551,18818459,15707470,34525929,8,0,1,512,1,2400276271
3552,18838119,10941412,29779531,4,0,0,40448,25,5211265171
3553,18840699,10199090,29039789,3,0,0,10240,21,3326124775
3554,18843491,15683744,34527235,5,0,1,2048,25,7746847038
3555,18846479,15681422,34527901,1,0,1,1024,5,8415455210
3556,18846929,15685158,34532087,1,0,1,6656,5,2299745681
3557,18847941,10657206,29505147,2,0,0,25088,19,4525830816
3558,18849759,15682994,34532753,1,0,1,1024,5,3151640634
3559,18850220,15762510,34612730,4,0,1,68096,25,2580548792
3560,18856159,10260024,29116183,4,0,0,14336,25,6190609954
3561,18857130,15755623,34612753,4,0,1,8192,25,8012141293
3562,18879030,10439998,29319028,5,0,0,83456,25,5621136796
3563,18881099,10615087,29496186,3,0,0,90624,21,6213103201
3564,18898150,10326155,29224305,5,0,0,15872,25,8974825256
3565,18902849,10335870,29238719,4,0,0,23040,25,6090631768
3566,18903009,11059602,29962611,4,0,0,138752,25,10022032218
3567,18907519,15705257,34612776,1,0,1,1536,5,5911375846
3568,18909010,15703789,34612799,4,0,1,15360,25,5189709863
3569,18910809,15702013,34612822,8,0,1,1024,1,5478694255
3570,18929250,10340184,29269434,5,0,0,10752,25,5722692110
3571,18936599,10487592,29424191,4,0,0,39424,25,2193169677
3572,18945619,15670213,34615832,8,0,1,5632,1,3221925120
3573,18949569,15671275,34620844,1,0,1,8192,5,1783643833
3574,18954329,15667079,34621408,1,0,1,10752,5,10060129092
3575,18955931,10490752,29446683,2,0,0,4096,19,10421523692
3576,18959790,10537667,29497457,5,0,0,4096,25,2754247196
3577,18960200,15742472,34702672,4,0,1,32768,25,2216934324
3578,18962469,15745933,34708402,1,0,1,3072,5,52250214
3579,18963380,15746648,34710028,3,0,1,2560,21,10330865620
3580,18968929,15743815,34712744,8,0,1,2560,1,8827659848
3581,18969750,15815199,34784949,4,0,1,92160,25,8421120891
3582,18980290,15878895,34859185,4,0,1,129024,25,7720342471
3583,18988779,10436635,29425414,4,0,0,3584,25,4768935690
3584,18990551,15890978,34881529,5,0,1,5632,25,4087166657
3585,18993341,15889494,34882835,5,0,1,2048,25,3121727129
3586,19000739,15882762,34883501,8,0,1,1024,1,233521801
3587,19002221,15884506,34886727,5,0,1,5120,25,6620615717
3588,19006759,15880429,34887188,8,0,1,10240,1,7426964603
3589,19009570,10739175,29748745,5,0,0,48640,25,480478096
3590,19010310,15881216,34891526,3,0,1,6656,21,2211222351
3591,19012169,15890217,34902386,8,0,1,1536,1,9727269423
3592,19015790,15890142,34905932,9,0,1,5632,4,8059450949
3593,19019131,10548636,29567767,2,0,0,12288,19,848240990
3594,19024640,10659486,29684126,5,0,0,19456,25,4222327561
3595,19025459,10637097,29662556,4,0,0,103424,25,7834893163
3596,19028169,10649325,29677494,4,0,0,18944,25,7972553940
3597,19037091,15871107,34908198,5,0,1,3584,25,1342234695
3598,19037129,10630598,29667727,4,0,0,16896,25,7766786347
3599,19047429,15861115,34908544,8,0,1,512,1,4447686775
3600,19049711,15861739,34911450,5,0,1,4608,25,9044922232
3601,19052570,15859226,34911796,6,0,1,512,17,3462120006
3602,19054009,15864559,34918568,8,0,1,10752,1,491328917
3603,19060649,15858585,34919234,1,0,1,11264,5,407120440
3604,19061449,15858041,34919490,1,0,1,9216,5,4025709441
3605,19062059,15866344,34928403,8,0,1,2048,1,890272532
3606,19062089,15866660,34928749,1,0,1,512,5,1364580773
3607,19063410,15903263,34966673,6,0,1,34304,17,2470592104
3608,19063650,10605550,29669200,5,0,0,4608,25,4102957647
3609,19071889,10785488,29857377,3,0,0,20480,21,4035969315
3610,19072009,15901436,34973445,1,0,1,10752,5,8519824018
3611,19072101,10768603,29840704,2,0,0,20480,19,3175542123
3612,19072279,15904072,34976351,8,0,1,4608,1,213104415
3613,19077420,15913317,34990737,3,0,1,4608,21,4010687241
3614,19079489,10711548,29791037,4,0,0,36864,25,9816478258
3615,19081011,10652891,29733902,2,0,0,21504,19,7471596794
3616,19081739,10698043,29779782,4,0,0,512,25,1570141178
3617,19087010,15903750,34990760,9,0,1,2560,4,10527554248
3618,19096219,15894849,34991068,1,0,1,3072,5,9751427525
3619,19097930,15893804,34991734,3,0,1,1024,21,504759964
3620,19102060,15894206,34996266,9,0,1,7168,4,10673119662
3621,19108289,10598183,29706472,3,0,0,10240,21,9236367652
3622,19115580,16096760,35212340,6,0,1,141824,17,8472630555
3623,19124060,16143403,35267463,3,0,1,28160,21,2134524644
3624,19126049,10841774,29967823,3,0,0,15872,21,6115726793
3625,19126200,16141286,35267486,9,0,1,3584,4,146129707
3626,19126510,16140999,35267509,9,0,1,3072,4,5014531261
3627,19127470,16140062,35267532,3,0,1,512,21,5141153815
3628,19132121,16135434,35267555,5,0,1,4096,25,6972494697
3629,19133679,16133899,35267578,1,0,1,2048,5,3342202387
3630,19134830,16220370,35355200,6,0,1,69120,17,5173997241
3631,19139180,11147649,30286829,5,0,0,56320,25,8774942586
3632,19141930,16542979,35684909,6,0,1,246272,17,8811696180
3633,19148939,11210622,30359561,3,0,0,26624,21,6258636411
3634,19156399,10977500,30133899,3,0,0,36864,21,7478813702
3635,19157911,11455887,30613798,2,0,0,23552,19,1008347812
3636,19161711,16535571,35697282,5,0,1,2560,25,4338881432
3637,19171060,16527208,35698268,9,0,1,1536,4,9521450732
3638,19173800,16526414,35700214,9,0,1,3072,4,2809163809
3639,19176149,16554792,35730941,8,0,1,19968,1,9696930762
3640,19196319,11045912,30242231,3,0,0,51200,21,5341862386
3641,19201721,16533112,35734833,5,0,1,6144,25,2094017657
3642,19207299,16532040,35739339,1,0,1,7168,5,8640021356
3643,19220820,16544542,35765362,6,0,1,39936,17,5175515463
3644,19226830,16590512,35817342,6,0,1,33792,17,1858228432
3645,19229000,16588365,35817365,3,0,1,6144,21,2567990787
3646,19232350,16594894,35827244,6,0,1,30720,17,5407747125
3647,19250511,16577092,35827603,5,0,1,9728,25,7701653063
3648,19251620,16601076,35852696,6,0,1,31744,17,1823942655
3649,19252680,16601124,35853804,9,0,1,512,4,4242085846
3650,19267080,16591870,35858950,9,0,1,8192,4,8371641340
3651,19268161,10924052,30192213,2,0,0,50688,19,7027945390
3652,19271221,16609166,35880387,5,0,1,1536,25,871017721
3653,19272030,16613503,35885533,6,0,1,8192,17,6863347038
3654,19276270,16637950,35914220,9,0,1,1024,4,8823074579
3655,19276871,16637695,35914566,5,0,1,512,25,10244000997
3656,19280069,11094397,30374466,3,0,0,9216,21,8450507825
3657,19283990,16635082,35919072,3,0,1,7168,21,8659811128
3658,19286991,16642808,35929799,5,0,1,14336,25,7816914724
3659,19287600,16643684,35931284,9,0,1,15360,4,5970302550
3660,19296100,16647669,35943769,9,0,1,2560,4,9619900169
3661,19299920,16699478,35999398,6,0,1,66048,17,870626943
3662,19310280,16690104,36000384,3,0,1,1536,21,2808458541
3663,19311080,16705166,36016246,6,0,1,41472,17,6509816111
3664,19324350,16693912,36018262,9,0,1,10240,4,1885980292
3665,19328250,16757735,36085985,9,0,1,31232,4,10471787432
3666,19328701,11056396,30385097,2,0,0,34816,19,3771693521
3667,19331840,16754168,36086008,9,0,1,3072,4,5906588630
3668,19340531,10995272,30335803,2,0,0,12288,19,10500176641
3669,19344939,16741092,36086031,1,0,1,1536,5,9948782432
3670,19345709,10811434,30157143,4,0,0,512,25,8384340450
3671,19345961,16740093,36086054,5,0,1,5632,25,4383227041
3672,19348289,16737788,36086077,1,0,1,2560,5,2963402878
3673,19348521,16737579,36086100,5,0,1,20992,25,7843713524
3674,19354509,11406312,30760821,3,0,0,17920,21,8396309204
3675,19357451,10973782,30331233,2,0,0,137216,19,1122620848
3676,19364490,16721633,36086123,9,0,1,1024,4,7384171211
3677,19371620,16714526,36086146,9,0,1,5632,4,9268684343
3678,19373039,16713130,36086169,1,0,1,5632,5,8781049489
3679,19373200,16712992,36086192,3,0,1,5120,21,5937404623
3680,19382501,16704556,36087057,5,0,1,3584,25,8767446071
3681,19383419,11340189,30723608,3,0,0,30208,21,2267898764
3682,19383520,16716487,36100007,6,0,1,34816,17,7631719506
3683,19398960,16703983,36102943,9,0,1,8704,4,10090676257
3684,19402860,16700749,36103609,6,0,1,1024,17,213025270
3685,19414770,16689505,36104275,9,0,1,1024,4,973660857
3686,19418720,16694659,36113379,6,0,1,21504,17,8610447630
3687,19419139,16706426,36125565,1,0,1,1024,5,6133670365
3688,19423879,11301819,30725698,4,0,0,1536,25,4553664130
3689,19424019,10936049,30360068,4,0,0,1536,25,4211816327
3690,19425381,16700530,36125911,5,0,1,512,25,1506948550
3691,19425680,16700897,36126577,9,0,1,1024,4,5980624576
3692,19425780,16728536,36154316,4,0,1,57856,25,2519791912
3693,19429240,16735921,36165161,9,0,1,1024,4,9001739906
3694,19437321,10719049,30156370,2,0,0,9216,19,9806012259
3695,19443330,11281877,30725207,5,0,0,5120,25,2905341612
3696,19444501,11176415,30620916,2,0,0,14336,19,4329674481
3697,19450991,10957402,30408393,2,0,0,8192,19,6660759495
3698,19455949,10943084,30399033,3,0,0,4608,21,9694248690
3699,19460070,16705437,36165507,9,0,1,512,4,10066182621
3700,19461480,16762379,36223859,6,0,1,95744,17,2413290271
3701,19463020,16813984,36277004,6,0,1,65024,17,9880018634
3702,19467870,10903765,30371635,5,0,0,37888,25,6506612024
3703,19468110,16810520,36278630,3,0,1,2560,21,7800437175
3704,19483219,16798957,36282176,1,0,1,5632,5,5145033321
3705,19484849,10847187,30332036,4,0,0,2560,25,5753447786
3706,19493619,11054436,30548055,4,0,0,3584,25,10220029676
3707,19499640,16783842,36283482,3,0,1,2048,21,2361501634
3708,19508329,16778379,36286708,1,0,1,5120,5,9718127508
3709,19517429,16770265,36287694,1,0,1,1536,5,4412114474
3710,19519150,16771450,36290600,9,0,1,4608,4,7221020527
3711,19519490,10831936,30351426,5,0,0,51200,25,8644043557
3712,19522529,16768417,36290946,1,0,1,512,5,193659144
3713,19525981,16769471,36295452,5,0,1,7168,25,1780171720
3714,19534409,16768950,36303359,1,0,1,512,5,7938227570
3715,19537390,16770155,36307545,9,0,1,6656,4,3257389096
3716,19544909,11336883,30881792,3,0,0,112128,21,2351561598
3717,19545030,16804102,36349132,3,0,1,9216,21,4279028302
3718,19547821,11148410,30696231,2,0,0,44032,19,171694258
3719,19553629,10834619,30388248,3,0,0,10240,21,6698672444
3720,19554711,11128081,30682792,2,0,0,22016,19,2180188606
3721,19560130,16789025,36349155,9,0,1,7680,4,4714661883
3722,19566890,16782288,36349178,3,0,1,1024,21,2774911067
3723,19567890,16781311,36349201,9,0,1,2048,4,4107809489
3724,19575159,16774065,36349224,1,0,1,512,5,329929575
3725,19576750,16772497,36349247,9,0,1,3072,4,6686390225
3726,19585770,11128611,30714381,5,0,0,47104,25,9018574328
3727,19590611,16758659,36349270,5,0,1,3072,25,6665361724
3728,19591210,16904392,36495602,6,0,1,137216,17,763302150
3729,19592591,11008149,30600740,2,0,0,4608,19,5404447858
3730,19594830,10899361,30494191,5,0,0,22016,25,2496574261
3731,19609649,10895814,30505463,3,0,0,14336,21,6863240885
3732,19614530,16898813,36513343,3,0,1,6656,21,3515212909
3733,19619169,11325199,30944368,4,0,0,25600,25,9956778765
3734,19622990,16891019,36514009,3,0,1,1024,21,252908357
3735,19630590,10811641,30442231,5,0,0,12800,25,281657645
3736,19632221,16882761,36514982,7,0,1,12800,21,1866046463
3737,19632720,11288202,30920922,5,0,0,31232,25,3021434175
3738,19640251,16925065,36565316,7,0,1,2048,21,6761386163
3739,19643249,11188751,30832000,3,0,0,180224,21,8105557850
3740,19643260,10757597,30400857,9,0,0,512,4,3448297711
3741,19646551,11335074,30981625,2,0,0,23040,19,8798421370
3742,19648509,11186345,30834854,3,0,0,8704,21,9478606620
3743,19649101,16927481,36576582,7,0,1,4608,21,8688078030
3744,19649200,11262175,30911375,5,0,0,96256,25,3133994215
3745,19650589,16946878,36597467,1,0,1,1024,5,135546156
3746,19651921,16946212,36598133,5,0,1,1024,25,10137436123
3747,19668970,16929509,36598479,3,0,1,512,21,6927984004
3748,19671840,16927305,36599145,9,0,1,1024,4,4650660355
3749,19683701,16916417,36600118,5,0,1,12800,25,8241055153
3750,19690310,11284272,30974582,5,0,0,41984,25,3197185019
3751,19694990,10875023,30570013,5,0,0,2560,25,1509256515
3752,19695961,16931900,36627861,7,0,1,1024,21,2663443454
3753,19704649,10923450,30628099,3,0,0,512,21,159035464
3754,19707159,16926301,36633460,1,0,1,2048,5,6075912411
3755,19710249,16923557,36633806,1,0,1,512,5,1621878948
3756,19715409,16920983,36636392,1,0,1,4096,5,4523273805
3757,19724501,10931574,30656075,2,0,0,17408,19,8449091455
3758,19726869,10894249,30621118,3,0,0,512,21,7827738908
3759,19730079,16906979,36637058,1,0,1,1024,5,10538981930
3760,19730379,10969619,30699998,4,0,0,12288,25,7088755029
3761,19732269,16910358,36642627,1,0,1,21504,5,10723473342
3762,19743731,16900202,36643933,7,0,1,2048,21,10078424040
3763,19744660,16995671,36740331,6,0,1,36352,17,301829147
3764,19747379,11100226,30847605,4,0,0,14848,25,10683287364
3765,19762761,11281745,31044506,2,0,0,9216,19,3168211507
3766,19766570,11076419,30842989,5,0,0,26624,25,1425364470
3767,19767311,16976566,36743877,7,0,1,5632,21,3765579714
3768,19769419,17045010,36814429,1,0,1,512,5,7869115113
3769,19772850,17041602,36814452,3,0,1,6656,21,3285057135
3770,19777250,17042396,36819646,6,0,1,4096,17,5667415207
3771,19786079,17033590,36819669,1,0,1,4096,5,4098963509
3772,19792511,10870615,30663126,2,0,0,512,19,2738094336
3773,19795211,11141334,30936545,2,0,0,51200,19,8112604772
3774,19799031,17045656,36844687,7,0,1,6656,21,7515257557
3775,19800719,11149600,30950319,4,0,0,19456,25,6263082706
3776,19804110,17115455,36919565,3,0,1,10240,21,2411592627
3777,19808489,11023690,30832179,3,0,0,512,21,5596893130
3778,19812891,11227669,31040560,2,0,0,26112,19,8470878973
3779,19816819,17125412,36942231,8,0,1,5632,1,5349901624
3780,19827649,11132728,30960377,4,0,0,24064,25,6787813706
3781,19854961,11304213,31159174,2,0,0,25088,19,926262375
3782,19858561,11174020,31032581,2,0,0,3072,19,5916296926
3783,19859299,17082955,36942254,1,0,1,6144,5,8201659066
3784,19866501,11156396,31022897,2,0,0,1536,19,5056867804
3785,19866909,17106082,36972991,1,0,1,6144,5,5437642660
3786,19876869,11294039,31170908,4,0,0,2048,25,2468669275
3787,19881220,17096597,36977817,6,0,1,7680,17,1996967195
3788,19890890,17088873,36979763,2,0,1,3072,19,5392006480
3789,19891419,11070065,30961484,3,0,0,3072,21,4352568310
3790,19893950,11058691,30952641,5,0,0,7168,25,5028755019
3791,19896489,11145186,31041675,4,0,0,3584,25,5942627433
3792,19898129,17082300,36980429,8,0,1,1024,1,5085205947
3793,19903109,17113244,37016353,1,0,1,7168,5,282217422
3794,19903610,17113409,37017019,2,0,1,1024,19,1180168557
3795,19905349,17112016,37017365,8,0,1,512,1,969447483
3796,19907960,11045039,30952999,5,0,0,1024,25,9850056119
3797,19908639,17109072,37017711,8,0,1,512,1,2096495277
3798,19910710,17186527,37097237,6,0,1,24576,17,9872134490
3799,19912401,11374151,31286552,2,0,0,81920,19,5259370501
3800,19913479,11397663,31311142,4,0,0,22528,25,2197963076
3801,19923620,17191947,37115567,3,0,1,15360,21,9048968814
3802,19925330,17240194,37165524,4,0,1,44032,25,10576101803
3803,19951431,11115927,31067358,2,0,0,13824,19,2379329167
3804,19960891,11410975,31371866,2,0,0,23040,19,6900033859
3805,19967799,11014340,30982139,4,0,0,1536,25,6720104151
3806,19969379,17199691,37169070,8,0,1,5632,1,4554190898
3807,19977209,11421966,31399175,3,0,0,512,21,8401354855
3808,19984319,17517240,37501559,6,0,1,156672,17,2212006208
3809,19985130,17522411,37507541,3,0,1,2048,21,4301508076
3810,19985659,17521905,37507564,6,0,1,6144,17,3790810881
3811,20020559,11060423,31080982,3,0,0,2560,21,3124528377
3812,20020759,17486828,37507587,1,0,1,4096,5,1918496915
3813,20026459,17494514,37520973,1,0,1,3072,5,1936181758
3814,20030239,17491707,37521946,1,0,1,12800,5,1853084990
3815,20040299,17636706,37677005,6,0,1,95744,17,10429334077
3816,20043130,17731562,37774692,4,0,1,15360,25,4496190119
3817,20061889,17714429,37776318,6,0,1,2560,17,1277384790
3818,20064881,11622593,31687474,2,0,0,41984,19,7744445589
3819,20068219,17793186,37861405,6,0,1,51712,17,8023737281
3820,20070169,17791259,37861428,1,0,1,8192,5,7165807979
3821,20077240,17784211,37861451,3,0,1,1536,21,517167598
3822,20077590,17783884,37861474,3,0,1,6144,21,642594398
3823,20079199,11353354,31432553,3,0,0,3072,21,2723839345
3824,20085669,17782403,37868072,8,0,1,16896,1,5587182158
3825,20096701,11201607,31298308,2,0,0,21504,19,2792228289
3826,20107260,17761022,37868282,3,0,1,3072,21,10568643530
3827,20112809,17755831,37868640,1,0,1,2048,5,189114724
3828,20119040,17749623,37868663,3,0,1,12800,21,781369353
3829,20121859,17746827,37868686,8,0,1,15872,1,4516151295
3830,20122869,17759916,37882785,6,0,1,33280,17,9957912420
3831,20127549,11777649,31905198,3,0,0,1536,21,3853060195
3832,20138940,17744409,37883349,3,0,1,10752,21,6271447911
3833,20141431,11352052,31493483,2,0,0,58880,19,2824401582
3834,20142269,11572704,31714973,4,0,0,46080,25,3105669920
3835,20159030,17724665,37883695,3,0,1,512,21,4160291153
3836,20159369,10979851,31139220,3,0,0,1536,21,418108808
3837,20165190,17728868,37894058,3,0,1,10752,21,290183827
3838,20165879,17728454,37894333,6,0,1,6144,17,6430404481
3839,20177499,17853379,38030878,8,0,1,118784,1,9136921363
3840,20180489,17914158,38094647,8,0,1,45568,1,460816527
3841,20183199,17914674,38097873,1,0,1,5120,5,338134133
3842,20185959,17912260,38098219,1,0,1,512,5,1781068439
3843,20199889,17919326,38119215,8,0,1,41472,1,657090582
3844,20203850,17925871,38129721,3,0,1,512,21,5906300325
3845,20212259,11263261,31475520,4,0,0,9728,25,4167417741
3846,20222439,17907846,38130285,1,0,1,10752,5,8509665252
3847,20223629,17918923,38142552,1,0,1,512,5,3879506602
3848,20225299,11392571,31617870,4,0,0,140288,25,462915117
3849,20229020,17913878,38142898,3,0,1,512,21,6483549460
3850,20238300,17906864,38145164,3,0,1,3584,21,1423349283
3851,20246649,17904519,38151168,8,0,1,20480,1,5575421139
3852,20257229,18072702,38329931,8,0,1,162816,1,1893299484
3853,20259661,11536791,31796452,2,0,0,11264,19,1132189751
3854,20262499,11547818,31810317,3,0,0,1536,21,3712329681
3855,20283920,18057948,38341868,3,0,1,512,21,6024395607
3856,20288939,18053800,38342739,1,0,1,12288,5,6771889544
3857,20291869,11472448,31764317,4,0,0,60928,25,2880308141
3858,20303049,11117972,31421021,3,0,0,512,21,8598272627
3859,20304229,11359597,31663826,4,0,0,18944,25,307209265
3860,20308469,11082044,31390513,3,0,0,512,21,6368007686
3861,20311619,10861913,31173532,3,0,0,512,21,8419874158
3862,20314129,11335115,31649244,4,0,0,60416,25,4105161481
3863,20324009,11294242,31618251,3,0,0,512,21,8810349722
3864,20351669,11681828,32033497,3,0,0,1024,21,3936259194
3865,20357249,11163183,31520432,4,0,0,29696,25,77395921
3866,20360889,11403607,31764496,3,0,0,512,21,6618252165
3867,20368559,10962591,31331150,4,0,0,20480,25,6426786861
3868,20368899,11015051,31383950,3,0,0,1024,21,7750428152
3869,20401779,17941946,38343725,1,0,1,1536,5,10664233610
3870,20427099,17917292,38344391,1,0,1,1024,5,3114460797
3871,20470819,17878192,38349011,1,0,1,3072,5,5293289898
3872,20486789,10902344,31389133,3,0,0,1024,21,993804823
3873,20487199,11133241,31620440,4,0,0,6656,25,6249355612
3874,20507059,11226027,31733086,3,0,0,1024,21,3319289163
3875,20548159,10843453,31391612,3,0,0,1024,21,6425945160
3876,20550289,11070486,31620775,3,0,0,1024,21,8489090881
3877,20550529,10983745,31534274,4,0,0,19456,25,9184443168
3878,20615860,17733190,38349050,9,0,1,15872,4,8821141315
3879,20618209,10876273,31494482,3,0,0,3072,21,8115402783
3880,20624770,17731829,38356599,9,0,1,512,4,6352970273
3881,20626399,17730866,38357265,1,0,1,1024,5,4497737739
3882,20629130,17731681,38360811,9,0,1,5632,4,9801100164
3883,20640829,17720968,38361797,1,0,1,1536,5,10308745209
3884,20657810,17704973,38362783,9,0,1,1536,4,647996638
3885,20664899,17700150,38365049,1,0,1,3584,5,9669367704
3886,20665970,17700705,38366675,9,0,1,2560,4,861580552
3887,20668429,10866492,31534921,3,0,0,2048,21,2841925924
3888,20676259,10835102,31511361,4,0,0,16896,25,4023962316
3889,20679649,17688012,38367661,1,0,1,1536,5,2778117183
3890,20683079,17684928,38368007,1,0,1,512,5,5614733083
3891,20683911,10891112,31575023,2,0,0,81408,19,6927557504
3892,20692859,17678469,38371328,1,0,1,1536,5,3530098800
3893,20722539,17657643,38380182,8,0,1,36864,1,7982766005
3894,20728831,10775141,31503972,2,0,0,17408,19,10524140426
3895,20733430,17712308,38445738,4,0,1,29696,25,9945564848
3896,20736139,10679085,31415224,3,0,0,512,21,3668604045
3897,20739339,17706963,38446302,1,0,1,10752,5,6357647518
3898,20744539,11296405,32040944,4,0,0,6656,25,3852825098
3899,20753689,17692767,38446456,1,0,1,8704,5,9040499494
3900,20756260,17697831,38454091,4,0,1,29184,25,120255270
3901,20765170,17711472,38476642,9,0,1,10240,4,4175047317
3902,20777199,17802158,38579357,8,0,1,54272,1,8927537363
3903,20785161,10738850,31524011,2,0,0,1536,19,6094862033
3904,20789429,17919408,38708837,1,0,1,32256,5,2069990794
3905,20790330,17955561,38745891,4,0,1,81408,25,3876520733
3906,20794080,17994533,38788613,9,0,1,19456,4,5399073619
3907,20798369,10939325,31737694,3,0,0,1024,21,5756119616
3908,20800129,10817920,31618049,3,0,0,512,21,522008470
3909,20800420,17995879,38796299,9,0,1,512,4,187375586
3910,20828129,18100113,38928242,8,0,1,109056,1,676321447
3911,20832259,11200903,32033162,4,0,0,107008,25,1144018006
3912,20832339,18099381,38931720,1,0,1,9728,5,7000226062
3913,20837339,10970753,31808092,3,0,0,512,21,5117037185
3914,20837740,18175436,39013176,4,0,1,110592,25,10570603608
3915,20838489,18226187,39064676,1,0,1,1536,5,8263764481
3916,20868969,10999069,31868038,3,0,0,1024,21,3346314191
3917,20874889,18214145,39089034,8,0,1,39424,1,2308337851
3918,20882340,18206848,39089188,4,0,1,8704,25,317102700
3919,20888021,10955447,31843468,2,0,0,58880,19,2322017082
3920,20892299,11090660,31982959,4,0,0,74752,25,5591316598
3921,20895229,18224526,39119755,1,0,1,12800,5,2796265660
3922,20895850,18266919,39162769,4,0,1,60416,25,9920916642
3923,20896949,18311561,39208510,1,0,1,2048,5,3276387431
3924,20909900,18298633,39208533,9,0,1,512,4,7774224249
3925,20912400,18356253,39268653,4,0,1,73216,25,2503855742
3926,20917929,18362091,39280020,1,0,1,2048,5,3087682415
3927,20922990,18358016,39281006,9,0,1,1536,4,4888397104
3928,20924111,10701804,31625915,2,0,0,1024,19,10687425723
3929,20931170,18351142,39282312,9,0,1,2048,4,3060107693
3930,20931340,18355068,39286408,9,0,1,15360,4,5548327739
3931,20935109,18391419,39326528,8,0,1,84992,1,9702385948
3932,20937319,10868735,31806054,3,0,0,1024,21,2576602493
3933,20937621,11017680,31955301,2,0,0,15872,19,4692553769
3934,20943391,18385723,39329114,7,0,1,4096,21,6418256189
3935,20946200,18387100,39333300,9,0,1,6656,4,7333379626
3936,20960451,11213460,32173911,2,0,0,222720,19,6377898751
3937,20971549,10725208,31696757,3,0,0,512,21,1674838473
3938,20979859,18355067,39334926,1,0,1,2560,5,1104046432
3939,20985629,10974531,31960160,4,0,0,15872,25,8854716508
3940,20987039,18449369,39436408,8,0,1,89088,1,8505900601
3941,20992690,18444064,39436754,3,0,1,512,21,3374050254
3942,20993910,18443190,39437100,0,0,1,512,8,6332293224
3943,20994950,18446656,39441606,4,0,1,7168,25,10373687058
3944,20996369,18446223,39442592,1,0,1,1536,5,7234147062
3945,20997790,18445148,39442938,0,0,1,512,8,3225988068
3946,20998060,18446363,39444423,3,0,1,15360,21,229480443
3947,21010799,10833119,31843918,3,0,0,1024,21,9371002543
3948,21011830,18471316,39483146,0,0,1,7168,8,9968466996
3949,21014041,11573415,32587456,2,0,0,9216,19,3343243459
3950,21017930,18489506,39507436,9,0,1,8192,4,7451360229
3951,21019959,18487500,39507459,1,0,1,6144,5,7234239164
3952,21020649,18520439,39541088,8,0,1,38400,1,7464257112
3953,21023960,18517474,39541434,9,0,1,512,4,3421640666
3954,21028619,18525284,39553903,8,0,1,51200,1,2276801913
3955,21036390,18530536,39566926,4,0,1,31232,25,251992586
3956,21036849,18711886,39748735,8,0,1,147456,1,9235258852
3957,21041909,18842916,39884825,8,0,1,120320,1,1589741316
3958,21042640,18848180,39890820,3,0,1,12800,21,5215217780
3959,21046941,11270138,32317079,2,0,0,43520,19,5863537077
3960,21050810,18841444,39892254,4,0,1,23040,25,2625247849
3961,21051500,18852720,39904220,0,0,1,2048,8,1370888828
3962,21075489,10803846,31879335,3,0,0,512,21,10702371507
3963,21077789,18830937,39908726,1,0,1,7168,5,8470886146
3964,21080869,18879202,39960071,8,0,1,74752,1,6214874586
3965,21081719,18880298,39962017,1,0,1,3072,5,10315914107
3966,21095520,18867803,39963323,3,0,1,2048,21,9910737175
3967,21096970,18868939,39965909,3,0,1,4096,21,3452498688
3968,21100160,18867375,39967535,0,0,1,2560,8,2402836422
3969,21109609,18858592,39968201,1,0,1,1024,5,7831921413
3970,21133210,18837577,39970787,3,0,1,4096,21,267686305
3971,21135610,18839043,39974653,3,0,1,6144,21,6787310634
3972,21140851,10911550,32052401,2,0,0,37376,19,1720503469
3973,21144189,10894681,32038870,4,0,0,17408,25,7478956417
3974,21146300,18829685,39975985,3,0,1,2048,21,9292564986
3975,21147240,18829731,39976971,0,0,1,1536,8,2346293676
3976,21148039,18829291,39977330,8,0,1,9728,1,4924948087
3977,21148659,18839041,39987700,8,0,1,33792,1,3849795056
3978,21156929,10826255,31983184,3,0,0,512,21,9387186296
3979,21158980,18843484,40002464,3,0,1,3584,21,10145506430
3980,21161389,10828729,31990118,3,0,0,1024,21,2964196667
3981,21162960,18844650,40007610,4,0,1,8192,25,1003036677
3982,21168741,18839637,40008378,5,0,1,11776,25,10036615638
3983,21168890,18841754,40010644,0,0,1,3584,8,1321199815
3984,21169119,11190647,32359766,3,0,0,2048,21,9543138596
3985,21169379,18885158,40054537,8,0,1,18432,1,10342736678
3986,21175420,18882023,40057443,3,0,1,4608,21,3670026729
3987,21176330,18886962,40063292,0,0,1,5632,8,6237302668
3988,21180759,18882994,40063753,8,0,1,10240,1,5356792547
3989,21183341,18894860,40078201,5,0,1,3584,25,5223447423
3990,21184129,18897315,40081444,1,0,1,1024,5,2632747746
3991,21189011,11044011,32233022,2,0,0,74752,19,4397630211
3992,21195519,18887551,40083070,1,0,1,2560,5,9597959613
3993,21197459,18886277,40083736,1,0,1,1024,5,7998454143
3994,21201609,11194572,32396181,4,0,0,45056,25,8303888858
3995,21211339,18924732,40136071,8,0,1,70144,1,1087558210
3996,21215869,11045990,32261859,4,0,0,20992,25,10674107348
3997,21221661,11331058,32552719,2,0,0,198144,19,1383824757
3998,21230469,11109797,32340266,3,0,0,1024,21,8299611189
3999,21231829,11095559,32327388,3,0,0,4608,21,4621527385
4000,21232711,18906906,40139617,5,0,1,5632,25,3571995522
4001,21236201,18904082,40140283,5,0,1,1024,25,3110088199
4002,21247339,10927132,32174471,3,0,0,1536,21,2874534997
4003,21249769,10999541,32249310,3,0,0,1536,21,9312226396
4004,21259701,11069192,32328893,2,0,0,512,19,1457419169
4005,21261010,18880246,40141256,4,0,1,12800,25,3171838277
4006,21264120,18877495,40141615,3,0,1,9728,21,2965404708
4007,21264360,18884402,40148762,3,0,1,12800,21,7290713626
4008,21270871,18882305,40153176,5,0,1,3072,25,1303148673
4009,21289550,18866301,40155851,4,0,1,26112,25,693057786
4010,21292639,11266678,32559317,4,0,0,20992,25,675393610
4011,21313570,18847427,40160997,2,0,1,8192,19,5344944102
4012,21314009,11045110,32359119,4,0,0,55296,25,6103729285
4013,21333449,11158875,32492324,4,0,0,90624,25,7587743749
4014,21337459,18870521,40207980,8,0,1,61952,1,9116553748
4015,21345241,18864213,40209454,7,0,1,1024,21,5437889528
4016,21351531,11058714,32410245,2,0,0,10240,19,8061375705
4017,21356481,18857098,40213579,7,0,1,3584,21,690872102
4018,21367989,11216567,32584556,3,0,0,512,21,3383078418
4019,21388579,11189067,32577646,4,0,0,57856,25,9618256865
4020,21392640,18824252,40216892,9,0,1,8192,4,10486937776
4021,21395521,18822997,40218518,7,0,1,2560,21,1033066662
4022,21411080,18812584,40223664,2,0,1,8192,19,9638835067
4023,21417570,18808680,40226250,3,0,1,4096,21,304075790
4024,21418611,11165766,32584377,2,0,0,22016,19,829285973
4025,21423049,11202874,32625923,4,0,0,59904,25,576431260
4026,21426010,18806867,40232877,0,0,1,4096,8,1543691600
4027,21440449,11119546,32559995,3,0,0,2048,21,171336017
4028,21442910,18791273,40234183,3,0,1,2048,21,3269153264
4029,21442960,18792849,40235809,3,0,1,2560,21,8316554429
4030,21444779,11162774,32607553,4,0,0,65024,25,1474736731
4031,21447079,11295395,32742474,3,0,0,1536,21,6751257055
4032,21452569,11447447,32900016,3,0,0,1024,21,3509116917
4033,21454831,18785484,40240315,7,0,1,7168,21,4096405304
4034,21455071,18790096,40245167,7,0,1,7680,21,1394930708
4035,21456960,18791113,40248073,3,0,1,4608,21,4894668308
4036,21475770,18775849,40251619,3,0,1,5632,21,1321491045
4037,21483199,11516916,33000115,4,0,0,70144,25,8393623196
4038,21503009,11570954,33073963,3,0,0,512,21,7600252405
4039,21503389,11204890,32708279,4,0,0,40960,25,2392334150
4040,21508600,18748986,40257586,3,0,1,4608,21,3379979665
4041,21509490,18749082,40258572,9,0,1,1536,4,9718121293
4042,21520151,18742607,40262758,7,0,1,6656,21,7141717791
4043,21533211,18748795,40282006,7,0,1,11264,21,9639750742
4044,21534880,18749712,40284592,3,0,1,4096,21,7950424185
4045,21538560,18754239,40292799,3,0,1,512,21,728770459
4046,21544479,11008419,32552898,3,0,0,512,21,482358096
4047,21550940,18747005,40297945,3,0,1,8192,21,6978103072
4048,21561080,18737851,40298931,4,0,1,1536,25,2724724272
4049,21565320,18836347,40401667,4,0,1,90112,25,2139480418
4050,21573441,11688731,33262172,2,0,0,70656,19,1757598355
4051,21573591,11313840,32887431,2,0,0,47616,19,5046494706
4052,21573851,11666770,33240621,2,0,0,212480,19,3942944213
4053,21577499,19176402,40753901,6,0,1,295936,17,6470033107
4054,21584479,11047448,32631927,3,0,0,1024,21,5981263346
4055,21590620,19208191,40798811,4,0,1,78848,25,1979342559
4056,21592739,11194465,32787204,3,0,0,1024,21,846047208
4057,21598370,19210637,40809007,9,0,1,2560,4,10130391670
4058,21611440,19207611,40819051,9,0,1,10752,4,3222945681
4059,21614780,19208457,40823237,3,0,1,6656,21,10011019884
4060,21620661,11251998,32872659,2,0,0,75776,19,9261032619
4061,21631071,11301673,32932744,2,0,0,41472,19,5988928653
4062,21636189,11696956,33333145,4,0,0,51712,25,9433705166
4063,21639281,19185582,40824863,7,0,1,2560,21,4099878877
4064,21641210,19192764,40833974,9,0,1,14848,4,3754511988
4065,21643810,19190187,40833997,9,0,1,1024,4,9075575834
4066,21655780,19186939,40842719,9,0,1,15872,4,10558824376
4067,21663349,11225665,32889014,4,0,0,5120,25,7177257703
4068,21665231,19178474,40843705,7,0,1,1536,21,4655243265
4069,21671109,19199321,40870430,1,0,1,2560,5,1384209311
4070,21671770,19216059,40887829,3,0,1,1536,21,7656216294
4071,21674081,19216334,40890415,7,0,1,4096,21,1930182655
4072,21675029,11274473,32949502,4,0,0,4608,25,10001269206
4073,21678900,19237185,40916085,4,0,1,85504,25,4873634065
4074,21682349,11232388,32914737,3,0,0,1024,21,3449732635
4075,21691791,11681151,33372942,2,0,0,35328,19,3409395668
4076,21691940,19251215,40943155,4,0,1,42496,25,6159542154
4077,21707779,11250621,32958400,3,0,0,3072,21,6269114275
4078,21708171,11466449,33174620,2,0,0,181760,19,3517706582
4079,21717780,19292039,41009819,4,0,1,120320,25,4134352615
4080,21721500,19292392,41013892,3,0,1,2048,21,1966517257
4081,21725929,11345541,33071470,4,0,0,15872,25,3790389306
4082,21726670,19288208,41014878,9,0,1,1536,4,4945178325
4083,21734490,19308378,41042868,6,0,1,23552,17,9512626293
4084,21746360,19296854,41043214,3,0,1,512,21,5954786131
4085,21752070,19311624,41063694,4,0,1,51712,25,8341341076
4086,21755171,10938880,32694051,2,0,0,2048,19,10449923126
4087,21756079,11176867,32932946,3,0,0,512,21,1016943217
4088,21763299,11524213,33287512,4,0,0,38400,25,8425705702
4089,21768950,19299142,41068092,9,0,1,1536,4,7746071913
4090,21769579,11349638,33119217,4,0,0,18944,25,4956491951
4091,21771661,19298377,41070038,5,0,1,3072,25,2873850890
4092,21772219,11403631,33175850,4,0,0,3072,25,481352019
4093,21775939,19315422,41091361,6,0,1,40960,17,6687066467
4094,21777670,19316597,41094267,4,0,1,4608,25,125774623
4095,21783111,19313422,41096533,7,0,1,3584,21,8483353422
4096,21785680,19313439,41099119,9,0,1,4096,4,5916590264
4097,21790779,11209671,33000450,3,0,0,1024,21,2345134316
4098,21794560,19307465,41102025,3,0,1,4608,21,693790017
4099,21795649,11379196,33174845,3,0,0,512,21,6800582204
4100,21811180,19296324,41107504,3,0,1,19968,21,10560136109
4101,21814171,19354638,41168809,7,0,1,15872,21,9526992670
4102,21819780,19349052,41168832,3,0,1,3584,21,4460563155
4103,21832119,11443670,33275789,3,0,0,512,21,1393497615
4104,21841030,19329265,41170295,6,0,1,4608,17,10668368996
4105,21843799,11059289,32903088,3,0,0,1024,21,4134946273
4106,21852020,19318736,41170756,0,0,1,10240,8,145090877
4107,21854591,11409187,33263778,2,0,0,5120,19,1459309966
4108,21862821,19308601,41171422,5,0,1,1024,25,445261248
4109,21870449,11439353,33309802,4,0,0,5120,25,1271186126
4110,21871721,11129532,33001253,2,0,0,2560,19,4922423338
4111,21892909,11420003,33312912,3,0,0,1024,21,6937619923
4112,21911449,19310198,41221647,6,0,1,41984,17,3215213369
4113,21922899,11352711,33275610,3,0,0,512,21,3869505792
4114,21932819,19292054,41224873,6,0,1,5120,17,859417659
4115,21938529,11368662,33307191,4,0,0,64512,25,5412898074
4116,21942431,11327298,33269729,2,0,0,19456,19,216300707
4117,21942891,19286816,41229707,7,0,1,12800,21,10525424084
4118,21946401,19300800,41247201,7,0,1,20480,21,2501398879
4119,21957139,11080125,33037264,3,0,0,512,21,1308994610
4120,21965391,19284379,41249770,5,0,1,512,25,3791031410
4121,21970491,11304940,33275431,2,0,0,15360,19,4144945226
4122,21972631,19293545,41266176,5,0,1,4096,25,9821577464
4123,21992571,19274591,41267162,7,0,1,1536,21,10289020645
4124,21993029,19322506,41315535,6,0,1,80384,17,3619496827
4125,22004429,19359553,41363982,6,0,1,4608,17,7876256719
4126,22016361,11523034,33539395,2,0,0,1536,19,3979128241
4127,22029441,19335527,41364968,5,0,1,1536,25,4827391490
4128,22033899,11273627,33307526,3,0,0,1024,21,8109734285
4129,22040079,11268140,33308219,3,0,0,1024,21,2222385427
4130,22040539,19351441,41391980,6,0,1,69120,17,7594958583
4131,22041179,19350824,41392003,6,0,1,17408,17,6109406275
4132,22046829,11223891,33270720,3,0,0,3072,21,2946594147
4133,22047139,19347694,41394833,6,0,1,4608,17,8054440571
4134,22054289,11324773,33379062,4,0,0,15360,25,10712600221
4135,22064239,11503833,33568072,4,0,0,86528,25,1742615230
4136,22066221,19329176,41395397,7,0,1,10752,21,758890122
4137,22067579,11240282,33307861,3,0,0,1024,21,4708507186
4138,22071611,11286414,33358025,2,0,0,52224,19,3782337053
4139,22081541,19317531,41399072,7,0,1,5120,21,7730770129
4140,22083429,11229048,33312477,4,0,0,8704,25,848506337
4141,22092501,19325218,41417719,5,0,1,18432,25,6573720422
4142,22093469,19333619,41427088,6,0,1,10240,17,5077073450
4143,22099249,19368582,41467831,6,0,1,3584,17,3530795419
4144,22110871,19358906,41469777,5,0,1,3072,25,1037351940
4145,22121369,19352914,41474283,6,0,1,7168,17,2885359332
4146,22121829,11195474,33317303,4,0,0,14336,25,8591333782
4147,22124851,19352193,41477044,5,0,1,3072,25,6714492180
4148,22136389,11221815,33358204,3,0,0,512,21,8069204524
4149,22146699,11333314,33480013,4,0,0,5120,25,10342937392
4150,22148869,11235461,33384330,4,0,0,7168,25,211543006
4151,22167021,19313249,41480270,5,0,1,5120,25,9054983706
4152,22168801,19313095,41481896,5,0,1,2560,25,8999812673
4153,22189411,19292831,41482242,7,0,1,512,21,9395791597
4154,22199701,19284807,41484508,5,0,1,3584,25,9727310778
4155,22202550,19290736,41493286,4,0,1,30208,25,1639106028
4156,22204849,19304656,41509505,6,0,1,8192,17,1842930616
4157,22205930,11186295,33392225,9,0,0,512,4,1694354194
4158,22224821,11228038,33452859,2,0,0,71680,19,7762886908
4159,22225091,19284760,41509851,5,0,1,512,25,7959127672
4160,22229510,19439025,41668535,4,0,1,194560,25,4999378664
4161,22237341,19472178,41709519,5,0,1,10752,25,10184851535
4162,22240239,19495771,41736010,6,0,1,512,17,311146465
4163,22243141,19494815,41737956,5,0,1,3072,25,3345416091
4164,22243821,19498961,41742782,5,0,1,7680,25,3943417699
4165,22244611,19500437,41745048,7,0,1,3584,21,8579355259
4166,22244709,19503245,41747954,6,0,1,4608,17,9764502116
4167,22245551,11372783,33618334,2,0,0,53760,19,7597664653
4168,22251359,11343892,33595251,3,0,0,2560,21,4220022988
4169,22252400,19514149,41766549,0,0,1,10752,8,4811923705
4170,22261880,19504692,41766572,4,0,1,14336,25,3277121986
4171,22262639,11192443,33455082,4,0,0,7168,25,4987459952
4172,22273610,19626360,41899970,4,0,1,120832,25,7613045544
4173,22278791,11298866,33577657,2,0,0,23040,19,9984473356
4174,22283690,19713701,41997391,4,0,1,79360,25,3046645777
4175,22306471,19694786,42001257,7,0,1,6144,21,7865976107
4176,22317329,11251234,33568563,3,0,0,1536,21,4364314578
4177,22325290,19755193,42080483,4,0,1,113664,25,4501316829
4178,22333449,11346796,33680245,4,0,0,59392,25,1785185648
4179,22355999,11175052,33531051,3,0,0,1024,21,6059799381
4180,22357921,19729963,42087884,5,0,1,6656,25,8386736075
4181,22364699,11155446,33520145,3,0,0,2048,21,5461143667
4182,22366520,19722350,42088870,2,0,1,1536,19,7786816097
4183,22371510,19780235,42151745,4,0,1,31744,25,6113664546
4184,22406321,19745770,42152091,7,0,1,512,21,8350719582
4185,22420109,11266555,33686664,4,0,0,20992,25,10539886483
4186,22429811,11070793,33500604,2,0,0,2560,19,5099265456
4187,22430519,11273640,33704159,4,0,0,57344,25,1614187741
4188,22433501,19740529,42174030,5,0,1,3072,25,10028496242
4189,22440439,11101084,33541523,3,0,0,512,21,5105563753
4190,22449131,19724922,42174053,5,0,1,3584,25,8903463673
4191,22459361,19714715,42174076,5,0,1,6144,25,8001670922
4192,22479031,11397426,33876457,2,0,0,6656,19,1215727523
4193,22500661,11300117,33800778,2,0,0,70144,19,268663722
4194,22500931,19673168,42174099,7,0,1,8192,21,3831377727
4195,22505799,11400646,33906445,4,0,0,81920,25,654522324
4196,22506529,11347149,33853678,3,0,0,2048,21,4328145110
4197,22509609,11200803,33710412,3,0,0,1536,21,1992466458
4198,22520111,19654011,42174122,7,0,1,1536,21,4849993746
4199,22524081,19650064,42174145,7,0,1,3584,21,9703258535
4200,22524091,11065040,33589131,2,0,0,7680,19,2132758207
4201,22532559,11047396,33579955,3,0,0,2048,21,1697249434
4202,22532989,11171521,33704510,3,0,0,1024,21,1888512483
4203,22538621,19651514,42190135,7,0,1,6144,21,6281752761
4204,22540261,19656160,42196421,7,0,1,14336,21,952768935
4205,22549259,11405408,33954667,4,0,0,7168,25,4601402902
4206,22552891,19643553,42196444,5,0,1,3072,25,944749504
4207,22560661,11310087,33870748,2,0,0,41984,19,6023847951
4208,22568261,19629458,42197719,7,0,1,3584,21,4075244229
4209,22570681,19642835,42213516,7,0,1,18432,21,4386757264
4210,22577221,19645757,42222978,7,0,1,1024,21,2024369474
4211,22578931,11081059,33659990,2,0,0,10240,19,6518708286
4212,22586741,19636801,42223542,7,0,1,10752,21,6204842048
4213,22589481,19637016,42226497,5,0,1,4096,25,8936328505
4214,22593609,11237567,33831176,4,0,0,69120,25,3167402589
4215,22595189,10975425,33570614,4,0,0,6656,25,6423240014
4216,22597311,19632092,42229403,7,0,1,4608,21,5967242401
4217,22607661,19622088,42229749,5,0,1,512,25,4236362942
4218,22607761,19623064,42230825,5,0,1,13312,25,859192514
4219,22611639,11265309,33876948,3,0,0,1536,21,6015756220
4220,22628349,11278477,33906826,3,0,0,1024,21,5350492732
4221,22643989,11230160,33874149,3,0,0,2048,21,10544367153
4222,22653139,11149472,33802611,3,0,0,1024,21,6017020503
4223,22653531,19586293,42239824,5,0,1,5120,25,9298914362
4224,22659039,11327070,33986109,3,0,0,512,21,9635240497
4225,22659109,11218174,33877283,3,0,0,1024,21,4276461775
4226,22663651,19576519,42240170,5,0,1,512,25,1984754224
4227,22686629,11018060,33704689,3,0,0,512,21,9717538700
4228,22687190,19553646,42240836,9,0,1,1024,4,6118453825
4229,22689741,11183549,33873290,2,0,0,8192,19,3087964012
4230,22700931,19543131,42244062,7,0,1,5120,21,2139507267
4231,22701211,19545437,42246648,5,0,1,4096,25,8028839812
4232,22719200,19544789,42263989,0,0,1,2560,8,6531406582
4233,22730011,11255919,33985930,2,0,0,25088,19,7830941025
4234,22745691,19519604,42265295,7,0,1,2048,21,9000129100
4235,22751911,19513730,42265641,7,0,1,512,21,2455736176
4236,22752129,11276872,34029001,3,0,0,1024,21,9460366072
4237,22767051,11340966,34108017,2,0,0,15872,19,5144577286
4238,22767409,11190803,33958212,3,0,0,512,21,3209801930
4239,22770041,19496586,42266627,5,0,1,1536,25,2478819083
4240,22772161,19506103,42278264,7,0,1,26624,21,4089681486
4241,22774361,19508409,42282770,7,0,1,7168,21,5656355876
4242,22789541,19493895,42283436,7,0,1,1024,21,2150820815
4243,22793011,19493331,42286342,5,0,1,4608,25,7656912434
4244,22795651,19492637,42288288,7,0,1,3072,21,475499609
4245,22797831,11219451,34017282,2,0,0,11776,19,6254653121
4246,22803501,19485773,42289274,5,0,1,1536,25,7861246208
4247,22806690,19490956,42297646,9,0,1,13312,4,8387128591
4248,22817291,19480701,42297992,5,0,1,512,25,341070750
4249,22827641,19470607,42298248,5,0,1,9216,25,275789476
4250,22833171,19479063,42312234,5,0,1,3072,25,3327918024
4251,22845630,19498321,42343951,9,0,1,21504,4,3037683234
4252,22860211,19483867,42344078,7,0,1,4096,21,2321336604
4253,22860381,19483720,42344101,7,0,1,3072,21,9741877323
4254,22866781,19477343,42344124,5,0,1,17408,25,8613087468
4255,22892791,19455401,42348192,5,0,1,11264,25,2538169422
4256,22893249,19486835,42380084,8,0,1,83968,1,10399709066
4257,22907149,11101470,34008619,3,0,0,512,21,10679142542
4258,22908061,19577926,42485987,7,0,1,2048,21,4287899727
4259,22911591,19577942,42489533,7,0,1,5632,21,747239580
4260,22918161,11269986,34188147,2,0,0,68608,19,5133428501
4261,22920911,19568968,42489879,5,0,1,512,25,9754399941
4262,22929481,19563304,42492785,5,0,1,4608,25,2119055536
4263,22940771,11189016,34129787,2,0,0,60416,19,1357478099
4264,22955819,19627137,42582956,8,0,1,16384,1,2043709805
4265,22958550,19658135,42616685,9,0,1,13824,4,3496055923
4266,22961729,19811648,42773377,8,0,1,65536,1,4931207272
4267,22963590,19940510,42904100,9,0,1,13312,4,8209022116
4268,22968100,19936023,42904123,9,0,1,512,4,4409365128
4269,22971440,19932706,42904146,9,0,1,4608,4,5893970175
4270,22984369,11158311,34142680,3,0,0,1536,21,914475958
4271,22996421,19907748,42904169,7,0,1,1024,21,7195330819
4272,23003561,19900631,42904192,7,0,1,512,21,9537485882
4273,23014621,19889594,42904215,7,0,1,5120,21,9111622050
4274,23020791,19898602,42919393,7,0,1,6656,21,9128130682
4275,23031060,19934159,42965219,4,0,1,93184,25,7725009309
4276,23035591,19929651,42965242,5,0,1,6144,25,5489796393
4277,23035871,19961272,42997143,7,0,1,13824,21,8005070275
4278,23039691,19957475,42997166,7,0,1,512,21,4062803121
4279,23052471,11089718,34142189,2,0,0,39424,19,7066526600
4280,23078279,19918910,42997189,6,0,1,4608,17,7043775277
4281,23083910,19913302,42997212,9,0,1,1024,4,8882978830
4282,23085941,19911294,42997235,5,0,1,7680,25,4030365196
4283,23093851,19904294,42998145,7,0,1,4608,21,9665559899
4284,23098499,19900414,42998913,6,0,1,11776,17,5513070891
4285,23102071,19898788,43000859,7,0,1,3072,21,7439905603
4286,23111940,19946781,43058721,9,0,1,18944,4,3340716881
4287,23117611,19941189,43058800,5,0,1,6656,25,4384844881
4288,23117999,19941315,43059314,6,0,1,6144,17,6717998219
4289,23123159,19939165,43062324,6,0,1,3584,17,7266490183
4290,23124570,19937777,43062347,9,0,1,3584,4,6928273573
4291,23134201,19928169,43062370,7,0,1,512,21,4091136074
4292,23134561,19927832,43062393,5,0,1,2048,25,3384990740
4293,23137910,19924506,43062416,4,0,1,3584,25,6578157483
4294,23142511,11117504,34260015,2,0,0,8704,19,9649624210
4295,23143170,19920072,43063242,9,0,1,512,4,4947983367
4296,23145121,19918144,43063265,5,0,1,4096,25,10009794025
4297,23152161,19911127,43063288,5,0,1,8704,25,3948027292
4298,23154369,11113095,34267464,3,0,0,1024,21,5057640058
4299,23160521,19902790,43063311,7,0,1,8704,21,3519682925
4300,23164521,11161238,34325759,2,0,0,31232,19,8534974598
4301,23168241,19895093,43063334,5,0,1,2560,25,7819416100
4302,23173721,19889636,43063357,7,0,1,3072,21,5700807897
4303,23181449,11101300,34282749,3,0,0,1536,21,6243592596
4304,23186449,11159711,34346160,3,0,0,1024,21,1061589067
4305,23191670,19871710,43063380,9,0,1,2048,4,8102527473
4306,23192020,19871383,43063403,9,0,1,4096,4,9707289703
4307,23192239,19871187,43063426,6,0,1,4608,17,10421362925
4308,23201860,19873321,43075181,4,0,1,34816,25,1094124860
4309,23212090,19873764,43085854,9,0,1,5120,4,796951652
4310,23212831,19882192,43095023,7,0,1,2560,21,8840102899
4311,23213230,19931844,43145074,4,0,1,47104,25,4699102004
4312,23213599,19931821,43145420,6,0,1,512,17,10651877438
4313,23214509,19931897,43146406,6,0,1,1536,17,4918274841
4314,23225751,19921014,43146765,7,0,1,9728,21,5116316267
4315,23226451,19930771,43157222,7,0,1,4608,21,2103221396
4316,23227219,11179009,34406228,3,0,0,2048,21,6769416994
4317,23228169,11321942,34550111,3,0,0,512,21,7941468801
4318,23229089,11383618,34612707,4,0,0,132608,25,2348832597
4319,23232940,19930344,43163284,9,0,1,512,4,1829854963
4320,23234490,19931700,43166190,9,0,1,4608,4,2352199799
4321,23251571,19915925,43167496,7,0,1,2048,21,9594172341
4322,23253529,19915913,43169442,6,0,1,3072,17,4617697190
4323,23255140,19932114,43187254,4,0,1,17920,25,3099145213
4324,23258320,19930240,43188560,9,0,1,2048,4,440659945
4325,23262389,19927477,43189866,6,0,1,2048,17,4272799542
4326,23267211,11388283,34655494,2,0,0,33792,19,5676349700
4327,23270040,20067677,43337717,4,0,1,53248,25,10198733046
4328,23283769,20053971,43337740,6,0,1,15360,17,7621582013
4329,23285210,20053108,43338318,0,0,1,8704,8,3937738615
4330,23301730,20055456,43357186,9,0,1,9728,4,6186001531
4331,23303069,11331743,34634812,3,0,0,1024,21,3116188344
4332,23304779,20052430,43357209,6,0,1,5120,17,4130045413
4333,23317151,20056468,43373619,7,0,1,4096,21,8070478094
4334,23318979,20057321,43376300,6,0,1,4096,17,7465880099
4335,23319721,20072677,43392398,7,0,1,14336,21,2916820013
4336,23329620,20063764,43393384,0,0,1,1536,8,5898103417
4337,23343840,20049890,43393730,9,0,1,512,4,2739143772
4338,23344451,11453087,34797538,2,0,0,23552,19,5567275524
4339,23349451,11266358,34615809,2,0,0,9728,19,9100439428
4340,23362029,11321802,34683831,3,0,0,512,21,4224423958
4341,23364130,20030586,43394716,0,0,1,1536,8,2045029364
4342,23365631,20042074,43407705,7,0,1,5632,21,10228705043
4343,23368759,11363083,34731842,3,0,0,1536,21,9996528752
4344,23371910,20262023,43633933,4,0,1,112128,25,4354032001
4345,23381401,20285555,43666956,5,0,1,512,25,10474959851
4346,23384801,20282178,43666979,7,0,1,1024,21,3494738496
4347,23396029,11288235,34684264,3,0,0,512,21,4122046080
4348,23410151,20256851,43667002,7,0,1,1536,21,1156252912
4349,23422989,20271203,43694192,1,0,1,2048,5,1437914187
4350,23435271,20258944,43694215,7,0,1,8704,21,6138163368
4351,23441991,20252255,43694246,5,0,1,4096,25,4597304864
4352,23445471,20248798,43694269,7,0,1,512,21,9813641876
4353,23458121,11418646,34876767,2,0,0,512,19,6480750010
4354,23481061,11377297,34858358,2,0,0,19456,19,2381337773
4355,23484151,20210141,43694292,7,0,1,9728,21,1422968822
4356,23500980,20193514,43694494,9,0,1,2560,4,4205364063
4357,23502431,20192086,43694517,5,0,1,512,25,8395370877
4358,23517599,11385618,34903217,3,0,0,512,21,8341901858
4359,23518931,20175609,43694540,7,0,1,2048,21,4302283728
4360,23520291,20174272,43694563,5,0,1,2048,25,6042874699
4361,23521501,11469213,34990714,2,0,0,32256,19,984730949
4362,23528431,20166155,43694586,7,0,1,3072,21,7688732178
4363,23548259,11392464,34940723,3,0,0,1024,21,5685144946
4364,23556361,20162087,43718448,5,0,1,3072,25,8718675334
4365,23556639,11455882,35012521,4,0,0,2048,25,7485505337
4366,23556931,20161540,43718471,7,0,1,6144,21,6081809447
4367,23559339,11593205,35152544,4,0,0,44544,25,10601162952
4368,23568660,20149834,43718494,9,0,1,13312,4,1710566964
4369,23587011,20133856,43720867,7,0,1,4608,21,7404552584
4370,23600801,20121372,43722173,5,0,1,2048,25,2770802691
4371,23612631,11560551,35173182,2,0,0,61952,19,2983351929
4372,23613199,11487642,35100841,3,0,0,1536,21,10451849912
4373,23618719,11348663,34967382,3,0,0,512,21,6034879587
4374,23628781,20100291,43729072,7,0,1,4096,21,4421944035
4375,23634839,11552570,35187409,4,0,0,46592,25,8937600986
4376,23636070,20111331,43747401,9,0,1,7168,4,5672504085
4377,23658369,11495914,35154283,4,0,0,5632,25,4861921329
4378,23661051,20086504,43747555,5,0,1,8704,25,2480530537
4379,23661231,20102931,43764162,5,0,1,1024,25,7962869303
4380,23668411,20099297,43767708,5,0,1,5632,25,2922893835
4381,23668620,20099434,43768054,0,0,1,512,8,7059595459
4382,23688870,20083370,43772240,9,0,1,6656,4,2120873456
4383,23711650,20063816,43775466,9,0,1,5120,4,816867486
4384,23713840,20063252,43777092,9,0,1,2560,4,7315713346
4385,23729771,20047667,43777438,5,0,1,512,25,7325526844
4386,23743449,11560490,35303939,3,0,0,2560,21,8098506378
4387,23743910,20033874,43777784,3,0,1,512,21,7414179830
4388,23747701,11492066,35239767,2,0,0,33792,19,276807107
4389,23759461,11449155,35208616,2,0,0,34816,19,1065979482
4390,23761930,20016200,43778130,3,0,1,512,21,747468752
4391,23764509,20015567,43780076,8,0,1,3072,1,4385454917
4392,23780621,11486819,35267440,2,0,0,66560,19,983387215
4393,23783820,20013114,43796934,9,0,1,4608,4,792726352
4394,23784580,20012377,43796957,9,0,1,6656,4,6535393591
4395,23786110,20029457,43815567,3,0,1,8704,21,2529029502
4396,23792881,11531674,35324555,2,0,0,9728,19,2747630739
4397,23794929,20022111,43817040,8,0,1,23552,1,9247617807
4398,23796349,11392354,35188703,3,0,0,512,21,8258199774
4399,23796639,11391885,35188524,3,0,0,3584,21,4572105023
4400,23799451,20017620,43817071,5,0,1,12288,25,9673394285
4401,23804259,11522408,35326667,3,0,0,1536,21,5558418070
4402,23808679,20035767,43844446,1,0,1,6144,5,7084349097
4403,23818750,20025719,43844469,3,0,1,2560,21,6964429301
4404,23819989,11705242,35525231,4,0,0,57856,25,3954506867
4405,23822139,11654529,35476668,4,0,0,92160,25,9981447386
4406,23829899,11677681,35507580,4,0,0,16896,25,10379716169
4407,23842800,20001871,43844671,9,0,1,5120,4,2435030277
4408,23843439,20001255,43844694,8,0,1,16896,1,8548484720
4409,23851920,19992797,43844717,2,0,1,1536,19,10079063297
4410,23863340,20008101,43871441,3,0,1,1536,21,4381457890
4411,23863429,11728850,35592279,4,0,0,25088,25,2614433948
4412,23863480,20009267,43872747,9,0,1,2048,4,4686362848
4413,23896961,11665502,35562463,2,0,0,8192,19,1183913322
4414,23918849,11619517,35538366,4,0,0,43008,25,3823127507
4415,23918949,11665663,35584612,4,0,0,28160,25,1508097015
4416,23928521,11556282,35484803,2,0,0,26624,19,6907582257
4417,23942230,19931823,43874053,9,0,1,2048,4,9736567472
4418,23951521,11665653,35617174,2,0,0,53248,19,9022010361
4419,23963570,19914989,43878559,3,0,1,7168,21,2619386493
4420,23967469,11660792,35628261,3,0,0,1024,21,4790083016
4421,23972969,11742135,35715104,4,0,0,33792,25,9946751979
4422,23984690,19914354,43899044,3,0,1,512,21,8771090561
4423,23990090,19910260,43900350,9,0,1,2048,4,3147171242
4424,24009391,11646494,35655885,2,0,0,12800,19,5162735421
4425,24013350,19888946,43902296,3,0,1,3072,21,10248150147
4426,24018430,19927350,43945780,9,0,1,8192,4,8030280168
4427,24031291,11786020,35817311,2,0,0,57344,19,9288759793
4428,24039529,20202803,44242332,8,0,1,162304,1,6620198106
4429,24043829,11824615,35868444,3,0,0,512,21,10568382007
4430,24045599,11740219,35785818,4,0,0,26112,25,953014906
4431,24049270,20194794,44244064,3,0,1,512,21,4563336788
4432,24055269,11955285,36010554,3,0,0,1024,21,8322162376
4433,24063670,20194956,44258626,3,0,1,10240,21,2054320427
4434,24074340,20184309,44258649,3,0,1,2560,21,114911697
4435,24079859,20179460,44259319,6,0,1,5120,17,142458055
4436,24084489,20174853,44259342,6,0,1,512,17,6805522565
4437,24086261,11710374,35796635,2,0,0,10240,19,2198648624
4438,24112230,20147135,44259365,3,0,1,2560,21,810606220
4439,24113900,20145488,44259388,3,0,1,1536,21,9025770048
4440,24123991,11961636,36085627,2,0,0,129024,19,4319570031
4441,24146079,20192018,44338097,8,0,1,80384,1,4862037734
4442,24155790,20349425,44505215,4,0,1,118272,25,5613954207
4443,24167509,20398044,44565553,8,0,1,40448,1,1621812373
4444,24187459,11898503,36085962,3,0,0,1024,21,1053781115
4445,24192499,20389684,44582183,8,0,1,41984,1,2705010471
4446,24205600,20379712,44585312,9,0,1,12800,4,1628986915
4447,24209089,11878944,36088033,3,0,0,512,21,6887846234
4448,24212570,20444619,44657189,9,0,1,1024,4,991603946
4449,24214170,20443042,44657212,3,0,1,7680,21,2460129657
4450,24215140,20472741,44687881,3,0,1,512,21,7043480183
4451,24236440,20451464,44687904,9,0,1,2560,4,8206525130
4452,24236500,20470830,44707330,4,0,1,71168,25,5188545378
4453,24240259,12103523,36343782,4,0,0,92160,25,2405765353
4454,24243490,20465492,44708982,3,0,1,2560,21,9153565499
4455,24250560,20548071,44798631,4,0,1,146432,25,2261011036
4456,24257540,20554315,44811855,4,0,1,3584,25,9176105333
4457,24260039,12166914,36426953,4,0,0,39936,25,3146913060
4458,24266490,20547951,44814441,3,0,1,4096,21,2479331649
4459,24267519,20616020,44883539,6,0,1,4096,17,6949135549
4460,24267859,20615703,44883562,6,0,1,8704,17,6932574921
4461,24296829,20586756,44883585,8,0,1,18432,1,4090785889
4462,24301159,12146597,36447756,3,0,0,1536,21,1441183852
4463,24303809,12045300,36349109,4,0,0,17408,25,348984141
4464,24307259,20578400,44885659,8,0,1,31744,1,1756322015
4465,24309899,12049809,36359708,4,0,0,9216,25,8009397646
4466,24310501,12649092,36959593,2,0,0,56832,19,6768996328
4467,24316819,20739208,45056027,8,0,1,183808,1,6026599210
4468,24316889,20760205,45077094,6,0,1,14336,17,715843106
4469,24322140,20776208,45098348,4,0,1,65024,25,9767126188
4470,24328040,20771076,45099116,3,0,1,11776,21,9581777354
4471,24330349,12107797,36438146,4,0,0,23552,25,4646907325
4472,24335569,20765493,45101062,3,0,1,3072,21,1465644452
4473,24342649,11970572,36313221,3,0,0,512,21,1908726163
4474,24348331,12345850,36694181,2,0,0,3072,19,10030407577
4475,24352639,20755794,45108433,6,0,1,2560,17,4185287317
4476,24382350,12210918,36593268,5,0,0,31744,25,6386519342
4477,24384939,20740384,45125323,8,0,1,11264,1,10151032747
4478,24388360,20737629,45125989,9,0,1,1024,4,5705502823
4479,24393291,12264253,36657544,2,0,0,38912,19,8562456737
4480,24399690,20727925,45127615,9,0,1,2560,4,4102240787
4481,24401820,20727421,45129241,4,0,1,2560,25,5187626274
4482,24405419,12972775,37378194,4,0,0,84480,25,10354031108
4483,24412809,20717098,45129907,3,0,1,1024,21,1709192924
4484,24414010,12110242,36524252,5,0,0,2560,25,9187183521
4485,24428879,12010538,36439417,4,0,0,4096,25,2899703699
4486,24428939,20701634,45130573,3,0,1,1024,21,3868496675
4487,24438920,12285321,36724241,5,0,0,52736,25,5203457665
4488,24443009,20688870,45131879,6,0,1,2048,17,5535063574
4489,24459411,12368515,36827926,2,0,0,8192,19,6791172055
4490,24460959,20671586,45132545,3,0,1,1024,21,9604958228
4491,24467979,20674875,45142854,8,0,1,35840,1,5093429386
4492,24473509,11923650,36397159,3,0,0,512,21,6416907498
4493,24475030,20681590,45156620,9,0,1,18944,4,5557223912
4494,24480379,20704803,45185182,8,0,1,60928,1,6620914444
4495,24493929,12082630,36576559,4,0,0,33792,25,3233742916
4496,24494120,12425422,36919542,5,0,0,80896,25,10464604429
4497,24495580,20690268,45185848,9,0,1,1024,4,9152072342
4498,24505479,20682315,45187794,1,0,1,3072,5,5063199854
4499,24506020,20684040,45190060,9,0,1,3584,4,8699168734
4500,24512621,12737395,37250016,2,0,0,108544,19,107494682
4501,24514050,20676356,45190406,0,0,1,512,8,5500416765
4502,24517719,12011662,36529381,3,0,0,512,21,10071540476
4503,24520619,20673013,45193632,3,0,1,5120,21,3138771845
4504,24553290,12261100,36814390,5,0,0,100352,25,5660670194
4505,24557229,20702622,45259851,8,0,1,104448,1,972634158
4506,24558169,12404887,36963056,4,0,0,11264,25,8141602416
4507,24566250,13068974,37635224,5,0,0,91648,25,10280840608
4508,24583389,11895658,36479047,3,0,0,1024,21,4953098285
4509,24587009,11971184,36558193,4,0,0,2560,25,10070948149
4510,24594500,20704849,45299349,4,0,1,6656,25,6181829575
4511,24599961,12183651,36783612,2,0,0,24064,19,9848434711
4512,24601969,12092859,36694828,3,0,0,2048,21,1666211958
4513,24615609,20699304,45314913,8,0,1,18944,1,2984040651
4514,24620869,12063126,36683995,3,0,0,1024,21,7266085484
4515,24632790,12060432,36693222,5,0,0,15872,25,9675056199
4516,24643181,12323338,36966519,2,0,0,11264,19,10724602698
4517,24643230,20676509,45319739,4,0,1,7680,25,7910345269
4518,24645359,12246382,36891741,4,0,0,14336,25,1489437928
4519,24646081,12362785,37008866,2,0,0,8192,19,5664368630
4520,24652360,12167263,36819623,5,0,0,16896,25,5501464735
4521,24657380,20663345,45320725,4,0,1,1536,25,372026726
4522,24663080,20670917,45333997,0,0,1,9728,8,5013141551
4523,24672280,12810801,37483081,5,0,0,4096,25,1952724598
4524,24681031,12528816,37209847,2,0,0,45568,19,5626207677
4525,24683909,12283101,36967010,3,0,0,1536,21,9904838962
4526,24686489,20665012,45351501,6,0,1,4096,17,716998430
4527,24687419,12254789,36942208,4,0,0,74240,25,9712858917
4528,24687559,12404363,37091922,4,0,0,9216,25,252955717
4529,24697001,12564738,37261739,2,0,0,38400,19,3261787773
4530,24697799,12467452,37165251,3,0,0,1024,21,4226185952
4531,24711889,12346817,37058706,3,0,0,1024,21,2364488783
4532,24725569,12058222,36783791,3,0,0,512,21,3590826226
4533,24730450,20627148,45357598,4,0,1,6656,25,7238725174
4534,24733459,20624805,45358264,6,0,1,1024,17,7593507170
4535,24740390,12522776,37263166,5,0,0,4608,25,470979145
4536,24747600,20611330,45358930,4,0,1,11264,25,1758484987
4537,24756130,12511739,37267869,5,0,0,15360,25,4108837576
4538,24757610,12457751,37215361,5,0,0,15872,25,4422417918
4539,24774819,12265134,37039953,4,0,0,41472,25,5553068341
4540,24778230,12109120,36887350,5,0,0,31232,25,5830373589
4541,24781491,20584635,45366126,7,0,1,1024,21,5949127744
4542,24783719,20582753,45366472,6,0,1,512,17,6920673887
4543,24804439,12477191,37281630,3,0,0,512,21,10311594485
4544,24814951,12526439,37341390,2,0,0,35328,19,4721284058
4545,24820039,12646593,37466632,4,0,0,167936,25,9397486494
4546,24828440,20540938,45369378,9,0,1,4608,4,9290546351
4547,24855631,12339038,37194669,2,0,0,68096,19,3553326076
4548,24858629,12520056,37378685,4,0,0,1536,25,9422609982
4549,24858681,20511056,45369737,7,0,1,9728,21,9575153714
4550,24860980,20513609,45374589,2,0,1,7680,19,6428149299
4551,24873059,12790640,37663699,4,0,0,72192,25,9545827838
4552,24879841,20495094,45374935,7,0,1,512,21,6379645018
4553,24880931,20494670,45375601,7,0,1,1024,21,8169567613
4554,24890029,20489758,45379787,6,0,1,6656,17,1820305361
4555,24891110,12269845,37160955,5,0,0,2048,25,5391748597
4556,24900630,20534149,45434779,2,0,1,97792,19,6804999133
4557,24900741,20560927,45461668,7,0,1,15360,21,5222594200
4558,24901691,20565817,45467508,7,0,1,1536,21,9135535609
4559,24907830,20570521,45478351,2,0,1,35328,19,9732732327
4560,24916751,12371098,37287849,2,0,0,8704,19,10091343377
4561,24919900,12941482,37861382,5,0,0,73216,25,5878579257
4562,24922999,12132776,37055775,3,0,0,1536,21,769445935
4563,24925581,20564601,45490182,7,0,1,12800,21,4819358028
4564,24926181,12632291,37558472,2,0,0,50176,19,4280531076
4565,24930069,12348587,37278656,4,0,0,35328,25,832654168
4566,24930360,20640730,45571090,2,0,1,50688,19,9309525245
4567,24936350,12740632,37676982,5,0,0,43520,25,2334958148
4568,24946931,12249009,37195940,2,0,0,4096,19,6313461307
4569,24950530,20648441,45598971,2,0,1,23552,19,10137492072
4570,24958770,12456671,37415441,5,0,0,8704,25,5966534673
4571,24962951,20643889,45606840,7,0,1,1536,21,2257356289
4572,24973560,12341598,37315158,5,0,0,38912,25,9650849802
4573,24975659,12412877,37388536,4,0,0,32256,25,7898015879
4574,24979389,20631957,45611346,6,0,1,7168,17,4782315033
4575,24991101,20621551,45612652,7,0,1,2048,21,4106873300
4576,24991410,12510110,37501520,5,0,0,60416,25,56381049
4577,24993929,20622589,45616518,6,0,1,6144,17,6635688251
4578,25006441,12475034,37481475,2,0,0,48640,19,737409061
4579,25010761,12496749,37507510,2,0,0,19456,19,7616978828
4580,25011269,20608475,45619744,6,0,1,5120,17,10386038078
4581,25022419,12188083,37210502,3,0,0,2048,21,2919505456
4582,25022829,20601421,45624250,6,0,1,7168,17,2699297585
4583,25031819,20597820,45629639,6,0,1,17408,17,8996799896
4584,25032830,20597475,45630305,2,0,1,1024,19,1338388233
4585,25041381,12239178,37280559,2,0,0,6144,19,5085924721
4586,25044031,20587260,45631291,7,0,1,1536,21,2160945654
4587,25044859,12343856,37388715,3,0,0,512,21,1657904434
4588,25054731,20604076,45658807,7,0,1,9728,21,9530730163
4589,25058979,20599851,45658830,6,0,1,6144,17,9304207067
4590,25063931,20595257,45659188,7,0,1,1024,21,4623510211
4591,25064851,20594360,45659211,7,0,1,9216,21,2169371831
4592,25085819,20587034,45672853,6,0,1,1536,17,2339225030
4593,25091359,12390451,37481810,3,0,0,1024,21,4417803675
4594,25091671,20581205,45672876,7,0,1,3072,21,3154891640
4595,25094421,20578478,45672899,7,0,1,4096,21,5690335048
4596,25100691,20574370,45675061,7,0,1,7168,21,8865160279
4597,25106760,12487562,37594322,5,0,0,11776,25,8358394544
4598,25108849,12759200,37868049,4,0,0,21504,25,579736120
4599,25124999,12713873,37838872,4,0,0,186880,25,4695353841
4600,25129841,20546233,45676074,5,0,1,4096,25,6920739028
4601,25153111,20528109,45681220,7,0,1,8192,21,9668643458
4602,25164491,20517075,45681566,7,0,1,512,21,9095796016
4603,25172969,20509058,45682027,6,0,1,10240,17,7365610639
4604,25188409,20512709,45701118,8,0,1,52224,1,6560638260
4605,25194330,20537363,45731693,2,0,1,16384,19,5626667217
4606,25195580,20568268,45763848,2,0,1,26112,19,9647588230
4607,25195960,12403121,37599081,0,0,0,7168,8,7223918521
4608,25203720,20776515,45980235,2,0,1,175616,19,8218455319
4609,25207140,12515780,37722920,5,0,0,44544,25,6273666464
4610,25207780,20838741,46046521,2,0,1,96768,19,3654337068
4611,25208591,12561289,37769880,2,0,0,96768,19,8239284332
4612,25213060,21046950,46260010,2,0,1,200192,19,8734947725
4613,25216619,21048131,46264750,6,0,1,15360,17,4857766015
4614,25229519,21092179,46321698,8,0,1,20992,1,1166741086
4615,25242821,21079236,46322057,7,0,1,9728,21,3442710634
4616,25245680,21129283,46374963,2,0,1,82432,19,7722969310
4617,25246469,12523590,37770059,3,0,0,512,21,9611819923
4618,25248121,21128788,46376909,5,0,1,3072,25,9862535253
4619,25250839,12617412,37868251,3,0,0,512,21,3412461691
4620,25252221,21137020,46389241,7,0,1,33792,21,9141156260
4621,25259679,21162049,46421728,8,0,1,50176,1,6093502874
4622,25262639,21180990,46443629,6,0,1,2048,17,2332465593
4623,25263539,12575512,37839051,3,0,0,512,21,6143801624
4624,25272401,21171574,46443975,5,0,1,512,25,2042474105
4625,25274519,12619516,37894035,4,0,0,20992,25,5099444849
4626,25284671,21162850,46447521,7,0,1,5632,21,1408887785
4627,25284890,21164897,46449787,2,0,1,3584,19,250250694
4628,25286250,12661490,37947740,8,0,0,18944,1,810108987
4629,25286561,21168372,46454933,7,0,1,8192,21,7472312120
4630,25288289,12580328,37868617,3,0,0,1024,21,4528582363
4631,25299001,21167581,46466582,5,0,1,512,25,6997141870
4632,25303330,21175153,46478483,2,0,1,18944,19,6305863589
4633,25304329,21175140,46479469,6,0,1,1536,17,7126129371
4634,25304379,21178316,46482695,8,0,1,5120,1,6684809259
4635,25313730,12743532,38057262,8,0,0,20480,1,8303754464
4636,25327271,21168628,46495899,7,0,1,12800,21,8036082071
4637,25336190,12670830,38007020,8,0,0,3584,1,1452774439
4638,25339060,12863692,38202752,8,0,0,67584,1,9450027189
4639,25351329,12936764,38288093,3,0,0,13312,21,3923894179
4640,25356299,21158342,46514641,8,0,1,46080,1,1459251571
4641,25358090,21189277,46547367,2,0,1,80896,19,4137302856
4642,25365009,21183024,46548033,6,0,1,1024,17,5436666714
4643,25368149,21184416,46552565,6,0,1,7168,17,5446757236
4644,25370250,21184901,46555151,6,0,1,4096,17,6070464918
4645,25384370,12657493,38041863,5,0,0,29184,25,4742946802
4646,25391069,21170188,46561257,8,0,1,20992,1,4748232465
4647,25393421,21172688,46566109,7,0,1,7680,21,1382841781
4648,25394021,21172754,46566775,7,0,1,11264,21,8960566017
4649,25398291,21172184,46570475,5,0,1,14336,25,1083858607
4650,25402060,21170361,46572421,6,0,1,3072,17,3034684367
4651,25403330,21170397,46573727,6,0,1,2048,17,4534183904
4652,25406490,21168863,46575353,3,0,1,2560,21,6978898569
4653,25409160,12804762,38213922,8,0,0,3072,1,8108065782
4654,25415709,12766428,38182137,4,0,0,50688,25,7879890667
4655,25420349,12928639,38348988,4,0,0,9216,25,1488137118
4656,25432720,12774950,38207670,5,0,0,12800,25,1887319515
4657,25434190,12874674,38308864,5,0,0,68096,25,1706021472
4658,25440761,21138458,46579219,5,0,1,6144,25,3499052168
4659,25442729,21137796,46580525,1,0,1,2048,5,4028364753
4660,25444879,21156068,46600947,8,0,1,51712,1,8021579602
4661,25454359,21152259,46606618,8,0,1,22016,1,1172814818
4662,25456581,21151420,46608001,5,0,1,14848,25,8519972249
4663,25465219,12961437,38426656,4,0,0,31744,25,6861307370
4664,25465549,13253786,38719335,4,0,0,26624,25,753384710
4665,25467429,12994025,38461454,4,0,0,14336,25,5632343904
4666,25477249,13191138,38668387,3,0,0,154624,21,7797561215
4667,25480500,21166112,46646612,0,0,1,1024,8,7978821619
4668,25489591,21157367,46646958,5,0,1,512,25,7892483265
4669,25489829,21157475,46647304,3,0,1,512,21,3990831465
4670,25492559,13218641,38711200,4,0,0,7680,25,194396109
4671,25496581,21153949,46650530,5,0,1,5120,25,3959279187
4672,25508149,12863148,38371297,3,0,0,9216,21,2994061676
4673,25518821,21135895,46654716,7,0,1,6656,21,4763159254
4674,25536259,21118803,46655062,3,0,1,512,21,925146348
4675,25538309,12997762,38536071,4,0,0,18944,25,7144315067
4676,25549690,21107037,46656727,3,0,1,11776,21,1292727373
4677,25551959,21105024,46656983,3,0,1,9216,21,5071478878
4678,25558629,13150185,38708814,3,0,0,132608,21,5788228902
4679,25562450,13166892,38729342,8,0,0,32768,1,6959552382
4680,25563801,21096440,46660241,7,0,1,15360,21,6155131628
4681,25577971,21096912,46674883,7,0,1,12288,21,310918362
4682,25579811,21100769,46680580,7,0,1,2560,21,6484224068
4683,25580521,21101365,46681886,7,0,1,2048,21,8013092648
4684,25602239,21080313,46682552,3,0,1,1024,21,9481442487
4685,25608999,13148918,38757917,3,0,0,5632,21,1524762286
4686,25614479,21098778,46713257,3,0,1,16896,21,5125805152
4687,25620631,21092828,46713459,7,0,1,5632,21,2564431070
4688,25621059,13427815,39048874,4,0,0,30720,25,9106576206
4689,25622599,13224742,38847341,4,0,0,34304,25,5500766233
4690,25634940,13293279,38928219,8,0,0,147968,1,333352522
4691,25641871,21099102,46740973,7,0,1,8192,21,7465201548
4692,25642951,21100608,46743559,7,0,1,4096,21,3348130916
4693,25646600,21098265,46744865,6,0,1,2048,17,9833922818
4694,25654410,13079651,38734061,8,0,0,15360,1,10316011639
4695,25658289,13273408,38931697,4,0,0,11264,25,3752586319
4696,25663051,21082787,46745838,7,0,1,12800,21,8911854588
4697,25677289,21105841,46783130,6,0,1,6656,17,3212805557
4698,25689459,21093694,46783153,6,0,1,8192,17,263628936
4699,25692081,21091095,46783176,7,0,1,4096,21,1337437773
4700,25692460,12916517,38608977,8,0,0,7168,1,5432565735
4701,25695171,21088028,46783199,7,0,1,8704,21,859370177
4702,25706100,21094835,46800935,2,0,1,68608,19,5279366263
4703,25707519,13167043,38874562,4,0,0,78336,25,5445083877
4704,25716079,21095574,46811653,6,0,1,5632,17,4021582417
4705,25721061,21104812,46825873,7,0,1,5632,21,8668211601
4706,25727110,13274594,39001704,8,0,0,79872,1,3915382234
4707,25730890,21129083,46859973,9,0,1,2048,4,1979559756
4708,25750989,13313664,39064653,3,0,0,51712,21,10102436647
4709,25751430,21128286,46879716,2,0,1,54272,19,9437357596
4710,25777259,13262232,39039491,4,0,0,71168,25,8377253508
4711,25786999,21093063,46880062,4,0,1,512,25,10103339728
4712,25789030,13326623,39115653,8,0,0,72704,1,3734950815
4713,25794020,21086913,46880933,9,0,1,12288,4,4191811299
4714,25794480,21092265,46886745,2,0,1,9216,19,6373790708
4715,25796731,21099155,46895886,7,0,1,23040,21,5935680543
4716,25802039,21095793,46897832,6,0,1,3072,17,10304843865
4717,25808820,21091624,46900444,2,0,1,4096,19,6437538327
4718,25810339,13309393,39119732,4,0,0,13312,25,8862060488
4719,25817860,21086130,46903990,9,0,1,5632,4,7849406877
4720,25819220,21142540,46961760,2,0,1,117760,19,10281237125
4721,25821259,13456203,39277462,4,0,0,14336,25,10190432651
4722,25828330,13374674,39203004,8,0,0,97280,1,1582869746
4723,25842411,21130142,46972553,7,0,1,7680,21,981937966
4724,25849410,13359077,39208487,8,0,0,17920,1,4051533249
4725,25853530,21119279,46972809,2,0,1,9216,19,2920409280
4726,25855201,21122114,46977315,7,0,1,7168,21,4059318693
4727,25857040,21127538,46984578,9,0,1,6144,4,5977208290
4728,25868450,13365808,39234258,8,0,0,7168,1,1412090189
4729,25870299,13341987,39212286,3,0,0,5632,21,3540636993
4730,25891751,21132731,47024482,7,0,1,18432,21,5658298302
4731,25892810,21172587,47065397,2,0,1,59392,19,703641012
4732,25903969,13635597,39539566,3,0,0,19456,21,6694387673
4733,25918719,13442782,39361501,3,0,0,34304,21,10361095223
4734,25919280,21146373,47065653,9,0,1,9216,4,4610915068
4735,25933660,13438190,39371850,8,0,0,27136,1,7146285737
4736,25940720,13566693,39507413,8,0,0,68608,1,4972668362
4737,25941050,21136492,47077542,2,0,1,6656,19,4293590788
4738,25944911,21132654,47077565,7,0,1,2560,21,2290517413
4739,25950719,13534547,39485266,4,0,0,2560,25,10006604001
4740,25953199,13723465,39676664,3,0,0,99328,21,9490997282
4741,25959789,13430152,39389941,3,0,0,1024,21,2041666181
4742,25979129,21099435,47078564,8,0,1,15360,1,6613251128
4743,25981241,21136640,47117881,7,0,1,7168,21,1518889359
4744,25985670,21133389,47119059,2,0,1,13824,19,5182332122
4745,25992910,13632227,39625137,8,0,0,28672,1,2452710032
4746,26014670,21104735,47119405,4,0,1,512,25,3978082910
4747,26027090,21093941,47121031,4,0,1,2560,25,10414198614
4748,26028099,13524513,39552612,3,0,0,30208,21,4391736662
4749,26038090,21083709,47121799,4,0,1,11776,25,3502294247
4750,26040061,21122750,47162811,5,0,1,1024,25,5313125361
4751,26040710,21122447,47163157,4,0,1,512,25,2011275596
4752,26041410,13685959,39727369,6,0,0,60928,17,2704471890
4753,26046030,21270165,47316195,2,0,1,158720,19,5443002939
4754,26056480,21269861,47326341,2,0,1,16384,19,6593678732
4755,26068541,21260066,47328607,7,0,1,3584,21,4026142062
4756,26070030,21261553,47331583,9,0,1,4096,4,9843881329
4757,26071311,21268875,47340186,5,0,1,8192,25,7378198714
4758,26074780,21266072,47340852,9,0,1,1024,4,1187924090
4759,26074889,13653907,39728796,3,0,0,4608,21,5870802590
4760,26084440,13685193,39769633,6,0,0,33280,17,6681653872
4761,26085670,21256168,47341838,9,0,1,1536,4,1861388220
4762,26089609,21344229,47433838,8,0,1,89600,1,2654911716
4763,26098929,13740712,39839641,4,0,0,53248,25,9087292141
4764,26104230,21340652,47444882,4,0,1,5120,25,7488246562
4765,26107011,21337894,47444905,5,0,1,512,25,9260219276
4766,26114740,21330815,47445555,4,0,1,8192,25,1631243373
4767,26122070,21351976,47474046,0,0,1,14336,8,7993780707
4768,26123239,13700155,39823394,3,0,0,72704,21,7707710371
4769,26125279,13759523,39884802,4,0,0,59904,25,1951840502
4770,26126560,21351032,47477592,9,0,1,5632,4,1507950143
4771,26130350,21387723,47518073,9,0,1,4096,4,3039071401
4772,26132890,13803826,39936716,8,0,0,8192,1,7409468594
4773,26137500,21380829,47518329,2,0,1,9216,19,9450561765
4774,26143470,21376165,47519635,4,0,1,2048,25,6289072414
4775,26155680,21364621,47520301,0,0,1,1024,8,5365289982
4776,26157830,13894627,40052457,6,0,0,5632,17,10000957841
4777,26158170,13932627,40090797,6,0,0,23040,17,8813509836
4778,26164211,21356436,47520647,5,0,1,512,25,5557547759
4779,26167320,21357193,47524513,9,0,1,6144,4,9545875501
4780,26168570,13761841,39930411,8,0,0,5632,1,2588858062
4781,26179939,13882939,40062878,4,0,0,4608,25,7723905101
4782,26184689,13968464,40153153,4,0,0,14336,25,336769572
4783,26186430,21349398,47535828,0,0,1,9728,8,5402919839
4784,26187099,21348883,47535982,6,0,1,8704,17,8465412378
4785,26188379,13960360,40148739,3,0,0,22016,21,9554398985
4786,26204661,21335507,47540168,5,0,1,6656,25,4793525815
4787,26211010,21358655,47569665,4,0,1,15872,25,8006511273
4788,26211370,21358318,47569688,0,0,1,5632,8,8917621497
4789,26212880,21356831,47569711,9,0,1,17920,4,10603044674
4790,26214150,21366033,47580183,0,0,1,512,8,4686552933
4791,26216419,21364750,47581169,6,0,1,1536,17,1492692264
4792,26217290,21364033,47581323,9,0,1,8704,4,3595816103
4793,26229300,21353009,47582309,4,0,1,1536,25,9524215182
4794,26234850,21351325,47586175,0,0,1,6144,8,1126589455
4795,26235830,21377871,47613701,4,0,1,1536,25,10177827717
4796,26236280,21380007,47616287,4,0,1,4096,25,4574037288
4797,26237900,21380333,47618233,6,0,1,3072,17,2879331708
4798,26239660,21379444,47619104,0,0,1,12288,8,4312849559
4799,26250221,21369229,47619450,5,0,1,512,25,7564386501
4800,26250280,21370156,47620436,9,0,1,1536,4,2825428307
4801,26256209,21365853,47622062,6,0,1,2560,17,4646490156
4802,26258090,21365278,47623368,4,0,1,2048,25,9749629415
4803,26259080,14180131,40439211,6,0,0,113152,17,9624591624
4804,26261610,21369656,47631266,9,0,1,2560,4,7203701294
4805,26262440,14195558,40457998,8,0,0,55808,1,8486855810
4806,26264450,21367482,47631932,9,0,1,1024,4,9298213113
4807,26265041,21368197,47633238,5,0,1,2048,25,8229465154
4808,26276840,14302836,40579676,6,0,0,14848,17,6692560094
4809,26279800,21354002,47633802,4,0,1,10752,25,3825360503
4810,26282470,21354570,47637040,9,0,1,11264,4,1590832900
4811,26283380,13930176,40213556,6,0,0,12288,17,10258927009
4812,26286899,14027669,40314568,4,0,0,1024,25,8273174525
4813,26291480,14073536,40365016,8,0,0,15360,1,1047617794
4814,26298310,21366771,47665081,9,0,1,1024,4,8541402034
4815,26303189,21362865,47666054,6,0,1,12800,17,10045147633
4816,26303450,14194217,40497667,6,0,0,37376,17,4797194688
4817,26304340,14324190,40628530,8,0,0,46592,1,8257931544
4818,26313610,14292640,40606250,8,0,0,21504,1,8289932013
4819,26314659,14154438,40469097,3,0,0,36352,21,10525414860
4820,26317319,14027285,40344604,3,0,0,13824,21,267161424
4821,26317780,21378933,47696713,4,0,1,6656,25,8868538967
4822,26320510,21376767,47697277,9,0,1,10752,4,597978262
4823,26332010,21367853,47699863,9,0,1,4096,4,5881404761
4824,26334900,21367549,47702449,9,0,1,4096,4,9000404756
4825,26341939,14233190,40575129,4,0,0,60928,25,3827870604
4826,26352789,14304991,40657780,3,0,0,35328,21,8288943010
4827,26357099,14140747,40497846,4,0,0,512,25,4306436575
4828,26358070,14395808,40753878,8,0,0,8192,1,3426544180
4829,26359169,14474782,40833951,4,0,0,26112,25,6863395068
4830,26359370,21449756,47809126,2,0,1,67072,19,9768846054
4831,26359660,14396454,40756114,0,0,0,3072,8,3225939122
4832,26360250,21530687,47890937,2,0,1,60928,19,9387852875
4833,26366040,14345187,40711227,8,0,0,14336,1,3793431442
4834,26368569,21523994,47892563,6,0,1,2560,17,10675453160
4835,26370779,21543359,47914138,6,0,1,3584,17,4127088815
4836,26380969,14394596,40775565,4,0,0,62464,25,8146516417
4837,26381320,21534124,47915444,4,0,1,2048,25,5812232708
4838,26392500,21523290,47915790,9,0,1,512,4,6199291664
4839,26403770,14195897,40599667,8,0,0,65536,1,1936371488
4840,26411020,21506396,47917416,9,0,1,2560,4,9841914946
4841,26415339,14282047,40697386,4,0,0,17920,25,673340457
4842,26427730,14547892,40975622,8,0,0,45568,1,2445778639
4843,26427820,14230607,40658427,8,0,0,2048,1,5701186124
4844,26435249,21485073,47920322,3,0,1,4608,21,1290848645
4845,26435410,21509478,47944888,2,0,1,27648,19,6761617984
4846,26436849,21508062,47944911,1,0,1,9728,5,9008664590
4847,26439700,21615726,48055426,2,0,1,146432,19,1743651508
4848,26443260,21612189,48055449,4,0,1,2048,25,9283872553
4849,26449199,21606273,48055472,3,0,1,1024,21,2648668640
4850,26451970,21603525,48055495,9,0,1,3072,4,5302600908
4851,26456690,21598828,48055518,4,0,1,4096,25,6985318523
4852,26471850,14552214,41024064,8,0,0,19456,1,1164984813
4853,26473940,21583902,48057842,4,0,1,7168,25,7391830689
4854,26474310,14389347,40863657,8,0,0,23552,1,3196676620
4855,26476300,21623150,48099450,2,0,1,11264,19,10213427667
4856,26479520,21630243,48109763,2,0,1,12288,19,7486747850
4857,26480520,21763944,48244464,2,0,1,64000,19,6821485324
4858,26494299,21750196,48244495,3,0,1,512,21,1244370509
4859,26498419,21746099,48244518,3,0,1,512,21,8111070891
4860,26500640,14351266,40851906,8,0,0,26624,1,8519077051
4861,26505089,21739452,48244541,3,0,1,14848,21,8776493379
4862,26512430,21732134,48244564,2,0,1,7680,19,1941318159
4863,26517149,21778492,48295641,3,0,1,6144,21,4434479851
4864,26520740,21774924,48295664,2,0,1,15872,19,1681762582
4865,26521750,21783628,48305378,4,0,1,2048,25,10715063737
4866,26528100,21780300,48308400,2,0,1,16384,19,5023786180
4867,26528250,21789225,48317475,9,0,1,512,4,276431681
4868,26537259,21783442,48320701,3,0,1,5120,21,3197477779
4869,26538760,21787519,48326279,4,0,1,7680,25,3413521144
4870,26540160,14606434,41146594,8,0,0,28160,1,7709487595
4871,26547431,21786207,48333638,7,0,1,10240,21,5239572360
4872,26551130,14488844,41039974,8,0,0,1536,1,10315833038
4873,26551890,21786126,48338016,9,0,1,5120,4,6957144342
4874,26554689,14614097,41168786,4,0,0,27136,25,6210211459
4875,26556121,21782241,48338362,5,0,1,512,25,383301664
4876,26557760,21793519,48351279,2,0,1,28672,19,9859007277
4877,26560231,21792367,48352598,7,0,1,13312,21,10055408098
4878,26570589,21783315,48353904,3,0,1,2048,21,4006425752
4879,26579389,21778701,48358090,6,0,1,6656,17,8600791941
4880,26583139,21816934,48400073,3,0,1,3072,21,70702237
4881,26583419,14550695,41134114,4,0,0,48640,25,3216499970
4882,26584750,21929135,48513885,2,0,1,139776,19,9302081090
4883,26590329,14625859,41216188,4,0,0,23552,25,262366179
4884,26599740,21916782,48516522,2,0,1,9216,19,934457854
4885,26604810,14545707,41150517,8,0,0,12800,1,8995515494
4886,26606799,14370718,40977517,3,0,0,6144,21,4769650063
4887,26610899,21917674,48528573,3,0,1,3072,21,10373918650
4888,26612690,21938036,48550726,2,0,1,35328,19,441567235
4889,26612989,14717131,41330120,3,0,0,19456,21,1296931616
4890,26622099,21932173,48554272,3,0,1,5632,21,3005053364
4891,26625040,21935491,48560531,4,0,1,3584,25,4771339151
4892,26627429,21959724,48587153,3,0,1,1024,21,996749737
4893,26631519,14615659,41247178,4,0,0,11264,25,2606892028
4894,26639601,21947575,48587176,7,0,1,5120,21,2152527267
4895,26644690,21942509,48587199,4,0,1,10752,25,2283524120
4896,26644999,14653135,41298134,3,0,0,7680,21,9981495458
4897,26649680,21962162,48611842,9,0,1,17920,4,6819796691
4898,26656940,21957808,48614748,4,0,1,4608,25,10514376973
4899,26666809,14725140,41391949,3,0,0,67072,21,2638866091
4900,26673370,22034520,48707890,2,0,1,78848,19,10527519663
4901,26676450,22043813,48720263,2,0,1,6144,19,2297745167
4902,26676560,22043726,48720286,9,0,1,2048,4,3504402666
4903,26679651,22040658,48720309,7,0,1,1024,21,3282495948
4904,26688419,22031913,48720332,6,0,1,5120,17,5046475063
4905,26690390,14741885,41432275,8,0,0,11776,1,7177550112
4906,26693060,14668817,41361877,8,0,0,14848,1,1380329572
4907,26699660,22060773,48760433,2,0,1,15872,19,8832870755
4908,26709300,22089900,48799200,2,0,1,61440,19,7911691826
4909,26710431,22090075,48800506,7,0,1,2048,21,3631613215
4910,26733529,14832333,41565862,3,0,0,29184,21,18512548
4911,26746470,22057262,48803732,9,0,1,5120,4,3889326224
4912,26754150,14846384,41600534,6,0,0,90624,17,3124230679
4913,26754889,14783958,41538847,4,0,0,45056,25,6636899985
4914,26757550,14968043,41725593,8,0,0,17920,1,5242176367
4915,26768550,22036168,48804718,4,0,1,1536,25,2041700825
4916,26786589,14979937,41766526,4,0,0,60416,25,417925260
4917,26790280,22014899,48805179,4,0,1,10240,25,4129578141
4918,26805590,14799959,41605549,8,0,0,16384,1,3079593545
4919,26810071,21995454,48805525,7,0,1,512,21,6028424255
4920,26816919,14976273,41793192,4,0,0,46080,25,9922724103
4921,26820021,21994243,48814264,7,0,1,6656,21,2670466220
4922,26825159,14990479,41815638,3,0,0,45056,21,2961995528
4923,26829389,15020264,41849653,4,0,0,6144,25,5998253144
4924,26830659,14999227,41829886,3,0,0,11264,21,4846541978
4925,26831929,21983001,48814930,6,0,1,1024,17,8331744940
4926,26839790,21976446,48816236,4,0,1,2048,25,7899166555
4927,26849829,14827937,41677766,4,0,0,22016,25,6697383506
4928,26857720,14851776,41709496,8,0,0,36352,1,1695099521
4929,26869380,21947522,48816902,4,0,1,1024,25,1764589002
4930,26878929,21973525,48852454,8,0,1,38400,1,1969499584
4931,26884590,21974730,48859320,4,0,1,4096,25,4228500375
4932,26887359,21972307,48859666,6,0,1,512,17,10241290583
4933,26894509,21967938,48862447,6,0,1,3072,17,9687700886
4934,26895731,21966747,48862478,7,0,1,512,21,10707295689
4935,26913150,21953314,48866464,4,0,1,7168,25,1890448894
4936,26918509,14779872,41698381,3,0,0,67584,21,65999241
4937,26925360,21942730,48868090,6,0,1,2560,17,4524345276
4938,26927339,21984305,48911644,8,0,1,31232,1,5710819586
4939,26931739,21979928,48911667,8,0,1,15872,1,7757263966
4940,26933050,21979216,48912266,4,0,1,2560,25,10380342577
4941,26946799,21966850,48913649,8,0,1,14848,1,8225625093
4942,26951210,14927344,41878554,6,0,0,6144,17,549482383
4943,26951289,14759197,41710486,3,0,0,3072,21,10324732291
4944,26953460,14993748,41947208,8,0,0,56832,1,6407532661
4945,26955129,22005865,48960994,8,0,1,95232,1,4232040153
4946,26971269,14890375,41861644,3,0,0,28672,21,303927742
4947,26974659,14690514,41665173,3,0,0,2560,21,1629158344
4948,26980899,22017503,48998402,6,0,1,16896,17,1590632363
4949,26984890,22013535,48998425,6,0,1,512,17,8274483404
4950,26984939,22013509,48998448,8,0,1,8704,1,2539806514
4951,26985150,14983706,41968856,8,0,0,9216,1,3281979036
4952,26995551,22002920,48998471,7,0,1,5632,21,6220818699
4953,26996390,22002104,48998494,4,0,1,1536,25,6814000784
4954,27000989,14918303,41919292,3,0,0,12800,21,8155311679
4955,27004381,21994136,48998517,7,0,1,2048,21,10432614227
4956,27004529,22012567,49017096,8,0,1,29696,1,10525738459
4957,27005351,22072010,49077361,7,0,1,13824,21,4542111666
4958,27024750,22052867,49077617,4,0,1,9216,25,10497281799
4959,27032440,22050077,49082517,2,0,1,4608,19,1108350252
4960,27041279,14887948,41929227,3,0,0,8192,21,10386626582
4961,27046710,22043379,49090089,4,0,1,3072,25,6214482452
4962,27047899,22056529,49104428,6,0,1,31232,17,2682707255
4963,27061869,15018591,42080460,4,0,0,89600,25,3208135403
4964,27064169,15109838,42174007,4,0,0,71680,25,577954778
4965,27065730,22238897,49304627,2,0,1,67072,19,7490051115
4966,27072529,22254358,49326887,8,0,1,29184,1,2834009003
4967,27077210,22318626,49395836,2,0,1,94208,19,5225324055
4968,27077501,22346016,49423517,7,0,1,10240,21,7905732980
4969,27082101,22341439,49423540,7,0,1,1024,21,7801416290
4970,27105999,15084081,42190080,3,0,0,52224,21,3315544551
4971,27107930,22320509,49428439,4,0,1,19456,25,527931951
4972,27117319,22319764,49437083,6,0,1,1536,17,6824411249
4973,27117809,14966597,42084406,4,0,0,12800,25,1038423123
4974,27121190,22317519,49438709,6,0,1,2560,17,1333462178
4975,27122499,14909164,42031663,3,0,0,6144,21,2236018823
4976,27122709,15221219,42343928,3,0,0,86528,21,3332076786
4977,27125499,15070899,42196398,3,0,0,20480,21,9183074785
4978,27127819,22362033,49489852,8,0,1,52736,1,1132352576
4979,27146130,22347512,49493642,2,0,1,15872,19,7183603784
4980,27147020,22359743,49506763,2,0,1,6144,19,2197110261
4981,27147290,22360459,49507749,2,0,1,1536,19,9159170372
4982,27157831,22356406,49514237,7,0,1,4096,21,8746381185
4983,27173961,22340299,49514260,7,0,1,3584,21,9968923166
4984,27176839,22343712,49520551,8,0,1,23552,1,3128571991
4985,27177389,22386552,49563941,8,0,1,44032,1,4211316405
4986,27183149,15448152,42631301,4,0,0,20992,25,1996169801
4987,27192679,22373235,49565914,8,0,1,23552,1,2240937070
4988,27203209,15317374,42520583,4,0,0,1536,25,7231827518
4989,27207149,15137310,42344459,4,0,0,1024,25,6835089068
4990,27224690,15675753,42900443,8,0,0,23040,1,6971581529
4991,27228371,22337889,49566260,7,0,1,512,21,6947289768
4992,27230620,15464782,42695402,8,0,0,36352,1,1332877490
4993,27235169,22333613,49568782,8,0,1,1536,1,3554888102
4994,27244970,22384071,49629041,2,0,1,101888,19,3125898424
4995,27245249,15621288,42866537,3,0,0,245248,21,5220151702
4996,27246650,15466894,42713544,8,0,0,6144,1,7100105520
4997,27255231,22376766,49631997,7,0,1,8192,21,1816644623
4998,27262419,15449230,42711649,3,0,0,53248,21,10538729950
4999,27264950,22409272,49674222,2,0,1,19968,19,1959670477
5000,27267989,15091733,42359722,4,0,0,1024,25,646316175
5001,27281691,22393837,49675528,7,0,1,2048,21,5077109994
5002,27282090,22459345,49741435,2,0,1,62464,19,8624681772
5003,27283940,22534316,49818256,2,0,1,80384,19,105914470
5004,27306430,22537669,49844099,2,0,1,7680,19,1157108
5005,27312209,22536396,49848605,8,0,1,7168,1,4080443712
5006,27316090,15649034,42965124,8,0,0,150016,1,6467053274
5007,27317619,22585604,49903223,8,0,1,51200,1,1427327942
5008,27318090,15575302,42893392,8,0,0,88064,1,5807233077
5009,27318430,15346986,42665416,8,0,0,13312,1,7844024551
5010,27319939,22585550,49905489,6,0,1,3584,17,639382111
5011,27322060,22683837,50005897,2,0,1,76288,19,1618427922
5012,27329459,22770615,50100074,8,0,1,112640,1,10051366752
5013,27350009,15708689,43058698,3,0,0,150016,21,1240358429
5014,27367760,15280015,42647775,8,0,0,38400,1,8245046888
5015,27374919,22769311,50144230,8,0,1,41472,1,8247403489
5016,27381239,22828137,50209376,6,0,1,5632,17,1572003097
5017,27381920,22827487,50209407,6,0,1,18944,17,2982753842
5018,27388719,22820711,50209430,8,0,1,8704,1,8055137084
5019,27389379,15514698,42904077,4,0,0,2048,25,7141760306
5020,27389400,22820053,50209453,6,0,1,2560,17,4940514882
5021,27427471,22782005,50209476,7,0,1,512,21,1845233297
5022,27437990,15353800,42791790,8,0,0,47104,1,6964220052
5023,27446240,22763259,50209499,2,0,1,3584,19,9734507060
5024,27447510,15455920,42903430,8,0,0,9728,1,1686064413
5025,27449380,15547553,42996933,8,0,0,103936,1,249952539
5026,27450881,22758641,50209522,7,0,1,512,21,4751322236
5027,27450980,22758565,50209545,2,0,1,1024,19,4945145593
5028,27455829,15463541,42919370,3,0,0,49664,21,8186602867
5029,27475129,22734439,50209568,3,0,1,4096,21,9237803824
5030,27479989,22729602,50209591,1,0,1,18944,5,4133187890
5031,27479999,22729615,50209614,1,0,1,512,5,7537695046
5032,27484660,22732046,50216706,6,0,1,12288,17,7111714281
5033,27485299,15176038,42661337,3,0,0,38912,21,6704036353
5034,27495020,22764055,50259075,2,0,1,53760,19,9915039748
5035,27519800,22813595,50333395,2,0,1,14336,19,9120946768
5036,27532319,22801099,50333418,1,0,1,2560,5,9761666296
5037,27535309,22798132,50333441,1,0,1,2560,5,5805035016
5038,27542139,22791325,50333464,1,0,1,9216,5,7907137684
5039,27553461,22780026,50333487,7,0,1,9216,21,9963694993
5040,27570731,22762779,50333510,7,0,1,3584,21,9912841941
5041,27571391,22762142,50333533,7,0,1,5120,21,8666836683
5042,27572240,22761316,50333556,6,0,1,3584,17,948042159
5043,27582091,22767423,50349514,7,0,1,5120,21,6965141206
5044,27594640,22754897,50349537,6,0,1,5632,17,2664173278
5045,27605499,22744061,50349560,8,0,1,47616,1,10669423834
5046,27615360,22778865,50394225,2,0,1,67584,19,10350441795
5047,27617969,15394998,43012967,3,0,0,36864,21,10533330305
5048,27633560,22866032,50499592,2,0,1,163328,19,4182186642
5049,27634131,22898216,50532347,7,0,1,8192,21,6241861679
5050,27635730,22922640,50558370,2,0,1,53760,19,6376913863
5051,27643940,22984186,50628126,2,0,1,39424,19,7556324142
5052,27645679,15351441,42997120,4,0,0,512,25,1149764672
5053,27657119,15498189,43155308,4,0,0,1536,25,9185530690
5054,27657610,15404691,43062301,8,0,0,9728,1,8361123559
5055,27659171,22968978,50628149,7,0,1,1536,21,7511916228
5056,27665481,22962691,50628172,7,0,1,1536,21,3205007348
5057,27667579,15395640,43063219,4,0,0,2560,25,687324137
5058,27668739,22959456,50628195,8,0,1,2560,1,1866722248
5059,27670689,22997040,50667729,8,0,1,52224,1,8228117666
5060,27673250,15508290,43181540,8,0,0,30208,1,4762901796
5061,27673340,23000051,50673391,2,0,1,5632,19,8937381394
5062,27676639,15382652,43059291,4,0,0,1536,25,3481391783
5063,27676760,22996654,50673414,9,0,1,1536,4,10312977532
5064,27700940,22972497,50673437,2,0,1,7680,19,1407317263
5065,27702630,22970830,50673460,2,0,1,512,19,9447613323
5066,27711360,15428078,43139438,8,0,0,31232,1,3403500038
5067,27718919,23012955,50731874,8,0,1,46080,1,5237490024
5068,27734199,23041220,50775419,8,0,1,32256,1,7096587363
5069,27747380,23028062,50775442,2,0,1,3072,19,7658733792
5070,27750719,23024746,50775465,8,0,1,10240,1,10083918793
5071,27760800,15667248,43428048,8,0,0,15872,1,6218325209
5072,27763569,23011919,50775488,8,0,1,2048,1,6837911965
5073,27771149,15601182,43372331,3,0,0,8704,21,9800830283
5074,27771230,23011857,50783087,2,0,1,8704,19,2112430306
5075,27771809,15585579,43357388,4,0,0,512,25,10453972636
5076,27788030,23019078,50807108,2,0,1,12800,19,323443309
5077,27806600,15593595,43400195,1,0,0,1024,5,8753092121
5078,27811619,23000635,50812254,8,0,1,8192,1,2254806522
5079,27818220,22995980,50814200,2,0,1,3072,19,6494417028
5080,27832199,15270380,43102579,4,0,0,512,25,8135447393
5081,27832790,22994916,50827706,2,0,1,1024,19,8907545358
5082,27833450,15523713,43357163,8,0,0,49664,1,2633592123
5083,27834549,22997983,50832532,8,0,1,7680,1,7726347514
5084,27841900,15658103,43500003,8,0,0,112128,1,4291818333
5085,27855699,23078395,50934094,8,0,1,126976,1,9472607945
5086,27863820,23070620,50934440,2,0,1,512,19,389675757
5087,27873680,23063026,50936706,2,0,1,3584,19,3246333534
5088,27884710,23055222,50939932,2,0,1,5120,19,3252231008
5089,27904279,15605138,43509417,3,0,0,12800,21,8238082116
5090,27919310,23025128,50944438,2,0,1,7168,19,9477284085
5091,27924749,15412945,43337694,3,0,0,40960,21,2994269192
5092,27925940,23037955,50963895,2,0,1,512,19,5021981985
5093,27933350,23041821,50975171,2,0,1,14336,19,10080215977
5094,27938930,23037547,50976477,2,0,1,2048,19,2652856553
5095,27943630,15295267,43238897,1,0,0,1536,5,3862128232
5096,27943700,15350236,43293936,1,0,0,512,5,3115915642
5097,27973179,15403098,43376277,4,0,0,1536,25,10602657834
5098,27980219,15714252,43694471,4,0,0,512,25,3553401156
5099,27987639,15477998,43465637,3,0,0,81920,21,7656085823
5100,27990430,15955327,43945757,8,0,0,128512,1,748171320
5101,27992730,15569045,43561775,8,0,0,38400,1,9598297659
5102,28003859,22992227,50996086,8,0,1,41472,1,4574375153
5103,28023719,15158624,43182343,4,0,0,2560,25,5819565500
5104,28025540,15208437,43233977,1,0,0,512,5,5236823421
5105,28032050,15865590,43897640,1,0,0,512,5,6223441153
5106,28039230,22956879,50996109,6,0,1,4608,17,4532923904
5107,28041379,15578854,43620233,3,0,0,17408,21,3247463992
5108,28048839,15456655,43505494,3,0,0,17920,21,8503442572
5109,28056979,15787669,43844648,4,0,0,512,25,6742922048
5110,28059111,22940640,50999751,5,0,1,7168,25,854006534
5111,28061389,15735522,43796911,3,0,0,54272,21,6446999430
5112,28071250,22929167,51000417,2,0,1,1024,19,8800064632
5113,28074539,22929424,51003963,6,0,1,5632,17,1029897418
5114,28078110,15640315,43718425,8,0,0,29696,1,9409053091
5115,28081770,15656693,43738463,1,0,0,1024,5,3876320072
5116,28083889,15273834,43357723,4,0,0,1024,25,6697621118
5117,28086730,22921445,51008175,6,0,1,6656,17,1693183803
5118,28105990,15588179,43694169,8,0,0,89088,1,8818682321
5119,28106159,15416277,43522436,4,0,0,1536,25,8642241196
5120,28107029,22902452,51009481,6,0,1,2048,17,1399846234
5121,28110800,15399108,43509908,1,0,0,1536,5,8725701726
5122,28112959,15352857,43465816,4,0,0,512,25,8681657565
5123,28117791,22892049,51009840,5,0,1,9728,25,4295080352
5124,28124021,22890231,51014252,5,0,1,5632,25,2530346620
5125,28130719,15495153,43625872,3,0,0,18432,21,7935199731
5126,28131950,15534983,43666933,8,0,0,22016,1,4848897726
5127,28135690,22885060,51020750,4,0,1,3584,25,1408209787
5128,28138940,22882156,51021096,6,0,1,512,17,939789070
5129,28140129,15470644,43610773,4,0,0,1024,25,154478760
5130,28143380,15482827,43626207,1,0,0,1024,5,916648254
5131,28151701,22882936,51034637,5,0,1,15360,25,2455521038
5132,28153001,22883520,51036521,5,0,1,3584,25,9027605724
5133,28161141,22876366,51037507,5,0,1,1536,25,4258480062
5134,28165040,22886896,51051936,2,0,1,9216,19,9172774293
5135,28166851,22890577,51057428,5,0,1,8704,25,10138045133
5136,28170640,15869669,44040309,1,0,0,1536,5,7042061594
5137,28171509,15644237,43815746,4,0,0,512,25,4512977612
5138,28173340,22884434,51057774,4,0,1,512,25,1872006586
5139,28175801,22882639,51058440,5,0,1,1024,25,5341568923
5140,28176070,22885276,51061346,4,0,1,4608,25,3811737993
5141,28178729,15850398,44029127,3,0,0,28160,21,5980770396
5142,28203200,22862652,51065852,6,0,1,7168,17,6619700576
5143,28209120,22861238,51070358,2,0,1,7168,19,1295042572
5144,28214339,15510091,43724430,4,0,0,512,25,5297528931
5145,28216410,22855254,51071664,2,0,1,2048,19,7963186643
5146,28219491,22862467,51081958,5,0,1,1024,25,4767797044
5147,28219530,15596014,43815544,8,0,0,60928,1,9735336764
5148,28224209,15426151,43650360,4,0,0,512,25,6510082152
5149,28227320,22854661,51081981,2,0,1,5120,19,8273148869
5150,28227699,22854305,51082004,6,0,1,7680,17,10305765350
5151,28231160,22850867,51082027,2,0,1,9728,19,5790196732
5152,28235439,15866937,44102376,3,0,0,17920,21,4839229476
5153,28237320,15514704,43752024,1,0,0,2560,5,7933600388
5154,28237780,22890477,51128257,9,0,1,10240,4,1552678748
5155,28246399,15598024,43844423,3,0,0,66048,21,1471468829
5156,28256199,15764325,44020524,3,0,0,84480,21,909511285
5157,28265900,15993396,44259296,1,0,0,2048,5,8229357664
5158,28270051,22858872,51128923,5,0,1,1024,25,1386015118
5159,28274639,22855590,51130229,6,0,1,2048,17,8862016058
5160,28275031,22856184,51131215,5,0,1,1536,25,6560129305
5161,28277470,22854731,51132201,0,0,1,1536,8,2836452746
5162,28277530,15539487,43817017,8,0,0,4096,1,6304854627
5163,28278839,16169168,44448007,3,0,0,6656,21,2224879452
5164,28281239,15984568,44265807,3,0,0,20992,21,5216745538
5165,28285739,22846718,51132457,6,0,1,9216,17,9215889884
5166,28286430,22847013,51133443,6,0,1,1536,17,208031029
5167,28287410,22847659,51135069,0,0,1,2560,8,1539256448
5168,28289589,15935555,44225144,3,0,0,7680,21,1516329734
5169,28290390,22848225,51138615,2,0,1,5632,19,1246488134
5170,28291260,16120402,44411662,8,0,0,19968,1,8331986009
5171,28298540,22846070,51144610,6,0,1,8704,17,1400061715
5172,28300511,22846685,51147196,5,0,1,4096,25,9237520145
5173,28308919,15570137,43879056,4,0,0,512,25,1081453438
5174,28310239,15817707,44127946,3,0,0,47104,21,4399377856
5175,28312199,15855234,44167433,4,0,0,1024,25,4662209420
5176,28318079,15499327,43817406,4,0,0,1024,25,2449482395
5177,28324390,22823792,51148182,0,0,1,1536,8,2220708299
5178,28325240,22823608,51148848,9,0,1,1024,4,8033700780
5179,28332631,22819763,51152394,5,0,1,5632,25,7262720388
5180,28335210,16046267,44381477,8,0,0,91136,1,8141648520
5181,28335240,16069972,44405212,8,0,0,77824,1,7024523612
5182,28361361,22797634,51158995,5,0,1,7680,25,4083248279
5183,28367770,15843760,44211530,1,0,0,512,5,7442972104
5184,28369261,22794240,51163501,5,0,1,7168,25,9646744158
5185,28376609,15733590,44110199,3,0,0,25600,21,2061560088
5186,28379890,15878705,44258595,8,0,0,47616,1,9984828248
5187,28380020,16185502,44565522,8,0,0,18944,1,7366024005
5188,28390630,16073347,44463977,1,0,0,512,5,726952038
5189,28393051,22770796,51163847,5,0,1,512,25,9628115466
5190,28411350,22757643,51168993,2,0,1,8192,19,6011340932
5191,28424691,22768891,51193582,5,0,1,3584,25,9314103107
5192,28431460,22762468,51193928,2,0,1,512,19,5828579458
5193,28444800,22750754,51195554,2,0,1,2560,19,8514820423
5194,28446719,15762405,44209124,3,0,0,30720,21,8356343291
5195,28449740,22746480,51196220,2,0,1,1024,19,4958794415
5196,28453620,22747989,51201609,2,0,1,17408,19,8971385177
5197,28455719,15897228,44352947,3,0,0,39424,21,916412759
5198,28462159,15666434,44128593,4,0,0,2048,25,4012337656
5199,28471160,15576124,44047284,1,0,0,512,5,4013708720
5200,28487630,16071918,44559548,8,0,0,51712,1,1841974879
5201,28491669,15675429,44167098,3,0,0,26112,21,8476365968
5202,28495740,15542340,44038080,1,0,0,2048,5,10382978430
5203,28502609,16024352,44526961,3,0,0,32768,21,3109872418
5204,28510451,22693104,51203555,5,0,1,3072,25,4781220919
5205,28521250,22684917,51206167,2,0,1,4096,19,7012119190
5206,28531259,15696621,44227880,4,0,0,1536,25,142145546
5207,28534199,22676154,51210353,3,0,1,6656,21,1128218131
5208,28548120,22667379,51215499,2,0,1,8192,19,7160617099
5209,28552940,15852615,44405555,1,0,0,1024,5,9277196521
5210,28555739,22659914,51215653,3,0,1,8704,21,7094868812
5211,28567060,15561868,44128928,1,0,0,1024,5,6936973957
5212,28570389,22658989,51229378,1,0,1,2560,5,1160242501
5213,28570951,22659093,51230044,5,0,1,1024,25,8677712377
5214,28575321,22654877,51230198,5,0,1,8704,25,1163627437
5215,28577451,22749718,51327169,5,0,1,9728,25,2806430706
5216,28579650,15833639,44413289,1,0,0,512,5,8950910587
5217,28580390,22747125,51327515,2,0,1,512,19,1398879022
5218,28583749,22744432,51328181,3,0,1,1024,21,9565819081
5219,28586590,15623181,44209771,1,0,0,2048,5,2654080183
5220,28595490,22736557,51332047,2,0,1,6144,19,9235583269
5221,28601110,15714123,44315233,8,0,0,43520,1,5429851955
5222,28604759,22743161,51347920,3,0,1,14336,21,1380445962
5223,28605620,15584466,44190086,1,0,0,2560,5,228158944
5224,28608810,22795937,51404747,2,0,1,10752,19,9317983209
5225,28621060,22785633,51406693,6,0,1,3072,17,9720713001
5226,28621260,15651318,44272578,8,0,0,22016,1,5914893694
5227,28626680,22812403,51439083,2,0,1,9216,19,61910644
5228,28631899,22807207,51439106,1,0,1,512,5,3477265708
5229,28632939,16024227,44657166,3,0,0,31232,21,754184283
5230,28634859,22804270,51439129,1,0,1,512,5,2807213727
5231,28635060,22805813,51440873,6,0,1,7168,17,10613389677
5232,28637370,22805769,51443139,2,0,1,3584,19,5582965200
5233,28646351,22822013,51468364,5,0,1,9216,25,6447253344
5234,28654161,22815189,51469350,7,0,1,1536,21,4138734268
5235,28654391,22815305,51469696,5,0,1,512,25,4509072605
5236,28655130,22874770,51529900,6,0,1,6656,17,3629257144
5237,28656289,15645661,44301950,4,0,0,1536,25,3953259788
5238,28659701,22871185,51530886,7,0,1,1536,21,6922258293
5239,28664260,16023574,44687834,8,0,0,99840,1,8799576486
5240,28666741,22867051,51533792,5,0,1,4608,25,9454491942
5241,28666770,16215787,44882557,8,0,0,180736,1,10510399567
5242,28671459,15809373,44480832,4,0,0,512,25,3707580352
5243,28678029,22858029,51536058,1,0,1,3584,5,2721483874
5244,28686031,22851512,51537543,7,0,1,15360,21,7158738811
5245,28691921,22934488,51626409,7,0,1,512,21,1033813326
5246,28694541,22932214,51626755,7,0,1,512,21,5635343234
5247,28697601,22929820,51627421,7,0,1,1024,21,5142528696
5248,28702061,22925706,51627767,5,0,1,512,25,9503685497
5249,28706460,15853267,44559727,1,0,0,512,5,7233981741
5250,28714381,22976594,51690975,7,0,1,19968,21,8305419364
5251,28725419,22967182,51692601,1,0,1,2560,5,9230710209
5252,28729081,22974324,51703405,7,0,1,5120,21,6871844177
5253,28733560,22997979,51731539,2,0,1,6656,19,6783326782
5254,28740860,15707326,44448186,1,0,0,512,5,543231826
5255,28741689,16055904,44797593,3,0,0,83456,21,2999661366
5256,28762059,22969503,51731562,1,0,1,512,5,5232778536
5257,28771279,15931130,44702409,4,0,0,512,25,2903811261
5258,28784141,22950508,51734649,7,0,1,7680,21,10347485056
5259,28789831,22945484,51735315,5,0,1,11264,25,6515609077
5260,28796171,22941090,51737261,7,0,1,3072,21,7087849850
5261,28797940,22940307,51738247,6,0,1,1536,17,7840073712
5262,28798661,22952161,51750822,7,0,1,8192,21,5030564813
5263,28798740,15858651,44657391,1,0,0,512,5,6248371439
5264,28802360,23056312,51858672,2,0,1,4096,19,2285899001
5265,28803790,23054913,51858703,2,0,1,1024,19,9798261578
5266,28809889,16073627,44883516,4,0,0,3072,25,244020804
5267,28810540,23048186,51858726,6,0,1,512,17,3277369702
5268,28816540,23111780,51928320,2,0,1,8192,19,7269718319
5269,28824531,23106793,51931324,5,0,1,3072,25,5682547951
5270,28832011,23099979,51931990,7,0,1,1024,21,1971802324
5271,28840669,23094544,51935213,1,0,1,4096,5,6170831125
5272,28849160,23101703,51950863,6,0,1,10752,17,526761864
5273,28851071,23100458,51951529,7,0,1,1024,21,8415877529
5274,28855220,16079352,44934572,8,0,0,117248,1,7879478008
5275,28872090,23081065,51953155,6,0,1,2560,17,1704202540
5276,28874420,23088733,51963153,6,0,1,4096,17,1406870235
5277,28877490,23086431,51963921,2,0,1,11776,19,5288310498
5278,28878110,23086157,51964267,2,0,1,512,19,7254829442
5279,28879451,23085802,51965253,7,0,1,1536,21,8926074641
5280,28879479,23143966,52023445,1,0,1,2560,5,758839819
5281,28879809,16117251,44997060,4,0,0,512,25,5324802203
5282,28889980,23133488,52023468,6,0,1,512,17,304647997
5283,28890001,23133490,52023491,5,0,1,4608,25,9546842204
5284,28903319,16173752,45077071,3,0,0,48640,21,7141289465
5285,28905350,15980286,44885636,8,0,0,6656,1,4880383814
5286,28914011,23109503,52023514,7,0,1,3584,21,7210902587
5287,28918901,23113239,52032140,5,0,1,6656,25,1511726049
5288,28922159,23110012,52032171,1,0,1,8192,5,10511992087
5289,28928230,23154251,52082481,6,0,1,6144,17,6668342433
5290,28929799,16094412,45024211,3,0,0,11264,21,1151210062
5291,28935280,16046116,44981396,1,0,0,512,5,4516180645
5292,28937069,16093833,45030902,4,0,0,1024,25,7149943342
5293,28940150,23219929,52160079,2,0,1,7680,19,2746099256
5294,28947530,23219482,52167012,2,0,1,7168,19,10041696817
5295,28948040,23218995,52167035,0,0,1,512,8,10728652663
5296,28949540,23217518,52167058,2,0,1,1024,19,14981928
5297,28949800,23217281,52167081,0,0,1,3072,8,424715929
5298,28950210,23216894,52167104,2,0,1,3072,19,7854578356
5299,28954870,23212257,52167127,2,0,1,6656,19,4592109663
5300,28954999,16175502,45130501,4,0,0,1024,25,9806373344
5301,28970311,23196839,52167150,7,0,1,6144,21,7059875794
5302,28975949,16166882,45142831,3,0,0,10752,21,1054432779
5303,28978799,23188553,52167352,1,0,1,7168,5,4882502736
5304,28992251,23175124,52167375,5,0,1,3584,25,6228908679
5305,28995669,16111942,45107611,4,0,0,1024,25,10166139407
5306,29000220,16216231,45216451,1,0,0,512,5,8600640210
5307,29006181,23161217,52167398,5,0,1,1536,25,2637604552
5308,29023730,16196472,45220202,1,0,0,1024,5,10410125852
5309,29030319,23141718,52172037,1,0,1,10240,5,5605178828
5310,29033809,23139534,52173343,8,0,1,2048,1,4960084863
5311,29041341,23135368,52176709,5,0,1,4608,25,206875555
5312,29053181,23133203,52186384,5,0,1,2048,25,1649219576
5313,29059939,16274027,45333966,3,0,0,4096,21,3025454368
5314,29076001,23110406,52186407,7,0,1,2560,21,1672188749
5315,29082759,16289156,45371915,4,0,0,512,25,4899709452
5316,29085110,16247585,45332695,8,0,0,21504,1,1176849137
5317,29086560,16406944,45493504,1,0,0,1024,5,7931854079
5318,29087390,23099040,52186430,2,0,1,8704,19,10174091098
5319,29097120,16364525,45461645,8,0,0,17408,1,6207708201
5320,29117279,23069174,52186453,1,0,1,3584,5,6642570194
5321,29122549,16163313,45285862,3,0,0,7168,21,8321216701
5322,29128379,16236948,45365327,3,0,0,14848,21,3212652680
5323,29145240,16279865,45425105,8,0,0,512,1,5516885990
5324,29150100,23037845,52187945,2,0,1,5632,19,4872060348
5325,29157049,16736102,45893151,4,0,0,4096,25,9046740764
5326,29159780,23028511,52188291,0,0,1,512,8,2128246069
5327,29160380,23028257,52188637,0,0,1,512,8,2778479098
5328,29162079,16496705,45658784,3,0,0,85504,21,150549420
5329,29167540,23026232,52193772,0,0,1,3072,8,4824176969
5330,29168009,23025786,52193795,1,0,1,1024,5,1145739860
5331,29171490,23022328,52193818,2,0,1,512,19,7403811424
5332,29171641,23022200,52193841,5,0,1,1536,25,324326837
5333,29176351,23018496,52194847,7,0,1,3584,21,7197779612
5334,29178970,16214474,45393444,1,0,0,1536,5,1530862181
5335,29180500,16897806,46078306,8,0,0,65024,1,8378955451
5336,29191051,23046133,52237184,5,0,1,8704,25,10283171926
5337,29191259,16481547,45672806,3,0,0,44544,21,2302673623
5338,29196969,16462196,45659165,3,0,0,1024,21,9113099013
5339,29203821,23036611,52240432,7,0,1,5632,21,166340339
5340,29214140,23047526,52261666,2,0,1,1536,19,1191703691
5341,29217231,23047981,52265212,5,0,1,5632,25,10543803084
5342,29232560,23047279,52279839,2,0,1,3072,19,6100054093
5343,29240649,23040816,52281465,1,0,1,2560,5,536730768
5344,29241560,16273095,45514655,1,0,0,1536,5,357646685
5345,29241839,16433199,45675038,3,0,0,6656,21,9826247242
5346,29243491,23046859,52290350,5,0,1,4608,25,5408332617
5347,29243631,23046742,52290373,5,0,1,1024,25,823921599
5348,29244480,16178983,45423463,1,0,0,512,5,3192890803
5349,29256709,16517482,45774191,3,0,0,9216,21,9269412705
5350,29262009,16501816,45763825,3,0,0,13824,21,9296828324
5351,29272309,16335003,45607312,4,0,0,512,25,6901414285
5352,29276729,16185785,45462514,4,0,0,512,25,1392496559
5353,29277800,23012596,52290396,2,0,1,3584,19,4159342062
5354,29283370,23044844,52328214,2,0,1,9216,19,2193651984
5355,29283890,16728313,46012203,8,0,0,61440,1,364464505
5356,29284830,23048530,52333360,2,0,1,8192,19,2674531251
5357,29287571,23046455,52334026,5,0,1,1024,25,4799099266
5358,29287729,16568829,45856558,4,0,0,1024,25,1067019777
5359,29290601,23044411,52335012,5,0,1,1536,25,8654879063
5360,29297100,23064377,52361477,2,0,1,512,19,2662156013
5361,29304299,16543940,45848239,3,0,0,57856,21,4888909217
5362,29304800,16577309,45882109,8,0,0,23040,1,10461417003
5363,29306649,23054851,52361500,1,0,1,512,5,6649564445
5364,29311190,23050333,52361523,9,0,1,5632,4,6334295472
5365,29313489,23049573,52363062,1,0,1,8704,5,8043226514
5366,29315649,23065856,52381505,8,0,1,16896,1,4237688189
5367,29323849,23165463,52489312,8,0,1,9216,1,2808506999
5368,29336700,23154878,52491578,2,0,1,3584,19,3767363887
5369,29336829,16491685,45828514,3,0,0,7680,21,8491830097
5370,29340770,23151474,52492244,6,0,1,1024,17,3560610488
5371,29343010,23149900,52492910,2,0,1,1024,19,4673689638
5372,29345479,23150337,52495816,1,0,1,4608,5,842486320
5373,29352739,16775039,46127778,3,0,0,70656,21,2797566466
5374,29354761,23311678,52666439,7,0,1,5120,21,8463321893
5375,29359810,23309855,52669665,2,0,1,5120,19,10428612360
5376,29364560,16489394,45853954,1,0,0,2560,5,5269331456
5377,29364639,23309532,52674171,1,0,1,7168,5,3931894063
5378,29365250,16555856,45921106,8,0,0,512,1,8756872834
5379,29373450,16718162,46091612,8,0,0,43008,1,6256218282
5380,29373640,16575435,45949075,8,0,0,14848,1,423184703
5381,29374109,16546818,45920927,3,0,0,17920,21,3046141386
5382,29380460,23296617,52677077,2,0,1,4608,19,10353219220
5383,29386559,23445650,52832209,8,0,1,37888,1,5332881281
5384,29388470,16517597,45906067,8,0,0,14848,1,8089804888
5385,29389389,23507921,52897310,8,0,1,48640,1,10346856057
5386,29412819,16613603,46026422,3,0,0,46592,21,3960132058
5387,29416531,23489910,52906441,7,0,1,6144,21,10027326804
5388,29422130,16464572,45886702,8,0,0,2560,1,2172851177
5389,29427450,16602863,46030313,1,0,0,512,5,5932868331
5390,29428061,23480256,52908317,5,0,1,2048,25,9374918043
5391,29429339,16727843,46157182,3,0,0,512,21,398986610
5392,29435001,23475582,52910583,5,0,1,3584,25,9227136933
5393,29436449,16445839,45882288,4,0,0,512,25,7052218530
5394,29444909,23570300,53015209,1,0,1,4608,5,7008942294
5395,29451529,16640262,46091791,4,0,0,512,25,9086388801
5396,29454611,23560621,53015232,5,0,1,2560,25,272602551
5397,29456230,23559025,53015255,6,0,1,2048,17,659289700
5398,29461109,23554169,53015278,3,0,1,1024,21,2208719937
5399,29466550,23549242,53015792,2,0,1,14848,19,5980299856
5400,29470151,23545664,53015815,5,0,1,5632,25,6058428893
5401,29470299,16682976,46153275,3,0,0,28160,21,18240422
5402,29472889,23543762,53016651,1,0,1,4096,5,8163011159
5403,29473900,16631437,46105337,8,0,0,14848,1,5155192278
5404,29485630,16730624,46216254,8,0,0,38400,1,1751889640
5405,29489630,16485227,45974857,1,0,0,2560,5,921168723
5406,29502249,23557042,53059291,1,0,1,3072,5,5126938791
5407,29507489,16570996,46078485,4,0,0,512,25,2014973087
5408,29509429,16583331,46092760,4,0,0,1024,25,8782969474
5409,29512920,16720673,46233593,8,0,0,56832,1,3896208061
5410,29513791,23545523,53059314,7,0,1,2048,21,5408372505
5411,29514950,16649736,46164686,1,0,0,512,5,784324284
5412,29525711,23533634,53059345,7,0,1,6656,21,5284417413
5413,29527780,23531588,53059368,2,0,1,2048,19,9983516559
5414,29528341,23531050,53059391,7,0,1,5120,21,7328456109
5415,29529429,16821662,46351091,3,0,0,57344,21,2388712961
5416,29540560,23582525,53123085,3,0,1,22528,21,1566036004
5417,29552789,23580279,53133068,8,0,1,45056,1,4660782734
5418,29554961,23578138,53133099,5,0,1,2560,25,3099719649
5419,29563809,23569855,53133664,1,0,1,2560,5,1176698840
5420,29567650,23585789,53153439,2,0,1,1536,19,3001268714
5421,29574861,23579564,53154425,5,0,1,1536,25,8947135161
5422,29575609,23580442,53156051,1,0,1,2560,5,890752156
5423,29584409,16653690,46238099,4,0,0,512,25,7061387357
5424,29584559,23572478,53157037,1,0,1,1536,5,795372955
5425,29584900,23575043,53159943,2,0,1,4608,19,531908102
5426,29584911,23576018,53160929,7,0,1,1536,21,9331725457
5427,29585701,23575574,53161275,5,0,1,512,25,2382082680
5428,29590760,23572615,53163375,2,0,1,11776,19,3670858905
5429,29595279,23601159,53196438,8,0,1,5632,1,5791218927
5430,29595539,23600922,53196461,3,0,1,1536,21,978733804
5431,29599811,23596877,53196688,5,0,1,1024,25,33644241
5432,29601829,23596165,53197994,8,0,1,2048,1,1988940747
5433,29602500,23596480,53198980,2,0,1,1536,19,9048527296
5434,29615539,23584747,53200286,3,0,1,2048,21,2068145258
5435,29625051,23576861,53201912,7,0,1,2560,21,352854256
5436,29630780,16897931,46528711,8,0,0,13824,1,5707537858
5437,29645039,17148257,46793296,4,0,0,512,25,1171955087
5438,29655269,16886391,46541660,4,0,0,1024,25,9238255750
5439,29657009,17056225,46713234,3,0,0,18432,21,6302136029
5440,29660131,23542127,53202258,7,0,1,512,21,8672520528
5441,29669669,23534215,53203884,3,0,1,2560,21,7260853642
5442,29679651,23582448,53262099,5,0,1,10752,25,9464899539
5443,29684740,17098367,46783107,8,0,0,108544,1,8942802464
5444,29691549,16848906,46540455,3,0,0,1024,21,4730523195
5445,29705309,23556813,53262122,3,0,1,4096,21,1503313270
5446,29708060,16998102,46706162,8,0,0,3584,1,3766469356
5447,29712851,23549294,53262145,5,0,1,6144,25,4131749754
5448,29722650,17018793,46741443,1,0,0,512,5,9372947150
5449,29723431,23538737,53262168,7,0,1,3072,21,196281319
5450,29730159,16983277,46713436,4,0,0,512,25,4296371743
5451,29733069,17010264,46743333,3,0,0,3584,21,779276083
5452,29735110,17188089,46923199,8,0,0,41984,1,4476406879
5453,29747290,16992617,46739907,1,0,0,512,5,9449604284
5454,29750459,23511732,53262191,3,0,1,11776,21,10374410633
5455,29750841,23549759,53300600,7,0,1,512,21,3087124621
5456,29756391,23545515,53301906,7,0,1,2048,21,3762580125
5457,29757729,23544331,53302060,8,0,1,8704,1,2770395619
5458,29769029,23533185,53302214,8,0,1,8704,1,4707197976
5459,29780741,23526183,53306924,7,0,1,2048,21,5415013002
5460,29780851,23570192,53351043,5,0,1,1536,25,10215558586
5461,29785490,17065833,46851323,1,0,0,512,5,7406663740
5462,29786059,23565445,53351504,3,0,1,10240,21,1134404740
5463,29789899,23566111,53356010,8,0,1,7168,1,4451511871
5464,29790499,23572620,53363119,3,0,1,12800,21,2490003363
5465,29796801,23566882,53363683,5,0,1,10752,25,3413164705
5466,29801839,17074632,46876471,3,0,0,9216,21,2414040713
5467,29804129,23570574,53374703,8,0,1,9216,1,640745051
5468,29804280,23573329,53377609,0,0,1,4608,8,4085055589
5469,29818269,23559686,53377955,8,0,1,512,1,8181638416
5470,29820760,16975845,46796605,1,0,0,1024,5,3964033219
5471,29834361,23546500,53380861,7,0,1,4608,21,8926816393
5472,29837661,23545466,53383127,7,0,1,3584,21,6651936760
5473,29842139,23558119,53400258,8,0,1,7680,1,8872264518
5474,29850580,23549701,53400281,6,0,1,3584,17,2847203442
5475,29850649,23549655,53400304,3,0,1,9216,21,6237111934
5476,29850729,23549598,53400327,8,0,1,2048,1,10124497663
5477,29852599,23547751,53400350,8,0,1,13312,1,4674817560
5478,29853080,23592241,53445321,3,0,1,10240,21,1959210006
5479,29859571,17065523,46925094,2,0,0,6144,19,6680179985
5480,29861551,23604577,53466128,7,0,1,2048,21,7902952231
5481,29864021,23602130,53466151,5,0,1,1536,25,215219123
5482,29864921,23601253,53466174,7,0,1,8704,21,6048899262
5483,29868590,23597607,53466197,6,0,1,2560,17,2027040425
5484,29871051,23595169,53466220,7,0,1,512,21,9163910518
5485,29877521,23588722,53466243,7,0,1,512,21,10552566612
5486,29881620,17049552,46931172,8,0,0,2048,1,5962482976
5487,29884970,16967143,46852113,1,0,0,1536,5,4191228282
5488,29890111,23576155,53466266,5,0,1,4096,25,40635725
5489,29897810,23589149,53486959,3,0,1,1024,21,1640539318
5490,29899159,16897111,46796270,4,0,0,2048,25,3527625847
5491,29906869,23580113,53486982,8,0,1,512,1,4743213128
5492,29917830,17303282,47221112,1,0,0,512,5,9176735614
5493,29919430,23629525,53548955,0,0,1,49664,8,7292497015
5494,29920220,23873354,53793574,0,0,1,125952,8,3755416797
5495,29932250,17316947,47249197,8,0,0,89600,1,5317473994
5496,29932740,17178991,47111731,8,0,0,98304,1,8355785750
5497,29934359,23912773,53847132,3,0,1,7168,21,10481541390
5498,29937639,23909839,53847478,8,0,1,512,1,3525840314
5499,29939030,17270219,47209249,8,0,0,119808,1,4485609930
5500,29958001,23890463,53848464,5,0,1,1536,25,8612640683
5501,29960429,23891581,53852010,1,0,1,5632,5,5796633318
5502,29962139,23890435,53852574,1,0,1,10752,5,837181887
5503,29963710,24089156,54052866,0,0,1,93184,8,10546016583
5504,29969689,24083200,54052889,1,0,1,1536,5,7312395702
5505,29972061,24085866,54057927,7,0,1,1536,21,8849886038
5506,29972539,24085411,54057950,3,0,1,3072,21,4023964440
5507,29975621,24082360,54057981,7,0,1,10752,21,10454556542
5508,29976160,24081844,54058004,6,0,1,11264,17,9330028739
5509,29977351,24087430,54064781,5,0,1,9216,25,2160894711
5510,29981280,17279038,47260318,5,0,0,27648,25,4541114053
5511,29985861,24110542,54096403,7,0,1,10752,21,6498637079
5512,29986521,24109905,54096426,7,0,1,6656,21,8828908010
5513,29988450,24107999,54096449,2,0,1,512,19,5843337844
5514,29988880,17306302,47295182,8,0,0,10240,1,148668188
5515,29993260,24103212,54096472,0,0,1,1536,8,4413521503
5516,29994821,24101674,54096495,7,0,1,13312,21,8712014808
5517,30009930,17067581,47077511,5,0,0,28160,25,10210709499
5518,30015140,24085554,54100694,6,0,1,2560,17,4568807448
5519,30017711,24092501,54110212,7,0,1,18432,21,389712120
5520,30024310,17377462,47401772,8,0,0,31744,1,5420187922
5521,30032750,17256824,47289574,5,0,0,18432,25,3833257777
5522,30034509,24078439,54112948,8,0,1,2560,1,9666321197
5523,30038601,24127729,54166330,5,0,1,2048,25,6392815690
5524,30044020,17358087,47402107,8,0,0,1024,1,1618117115
5525,30044130,24148011,54192141,0,0,1,75776,8,702870228
5526,30048730,24164147,54212877,0,0,1,26112,8,759885970
5527,30050099,24164084,54214183,3,0,1,2048,21,86339066
5528,30050191,24173404,54223595,5,0,1,11776,25,2417824218
5529,30051979,24174522,54226501,3,0,1,4608,21,2174411518
5530,30059650,17283955,47343605,1,0,0,2048,5,10542236115
5531,30063840,17369975,47433815,5,0,0,70144,25,757804139
5532,30067400,17224075,47291475,1,0,0,512,5,10366856474
5533,30067850,24168356,54236206,6,0,1,3584,17,2003916606
5534,30071439,24168525,54239964,1,0,1,2560,5,10136764621
5535,30076910,24229219,54306129,6,0,1,8704,17,5254538478
5536,30078289,17359316,47437605,3,0,0,12288,21,9306557938
5537,30080349,24225803,54306152,1,0,1,13312,5,2800293621
5538,30081420,17363439,47444859,5,0,0,9728,25,6260747963
5539,30082859,24223316,54306175,3,0,1,16896,21,2966365418
5540,30085449,24247661,54333110,3,0,1,2048,21,288113749
5541,30093260,24241156,54334416,6,0,1,2048,17,5900695308
5542,30097560,24248497,54346057,0,0,1,6656,8,5102765024
5543,30103280,17338592,47441872,8,0,0,11776,1,5366189633
5544,30108649,24246261,54354910,1,0,1,15872,5,911040233
5545,30113319,17671474,47784793,3,0,0,75776,21,1899231605
5546,30117130,24264648,54381778,0,0,1,38912,8,5970644774
5547,30117990,17451652,47569642,8,0,0,89088,1,2210588688
5548,30137279,24274200,54411479,1,0,1,4096,5,9009144826
5549,30140051,24271451,54411502,7,0,1,4608,21,5812845724
5550,30140530,24273145,54413675,6,0,1,2048,17,1679564211
5551,30146810,24269451,54416261,3,0,1,4096,21,2781066045
5552,30155401,24261731,54417132,7,0,1,12288,21,5541209635
5553,30159600,24369904,54529504,0,0,1,128000,8,2902679199
5554,30163510,17765019,47928529,8,0,0,3072,1,4884305625
5555,30167950,24440512,54608462,0,0,1,44032,8,737775492
5556,30168720,24439765,54608485,0,0,1,9216,8,574986465
5557,30169610,24445379,54614989,3,0,1,13312,21,7479665779
5558,30173889,17587793,47761682,3,0,0,122880,21,9472943803
5559,30177259,24437986,54615245,8,0,1,9216,1,5333837306
5560,30193981,24432711,54626692,5,0,1,4096,25,2278117299
5561,30194549,24432809,54627358,1,0,1,1024,5,655701830
5562,30199460,17588952,47788412,5,0,0,11776,25,500587920
5563,30199840,17476382,47676222,1,0,0,512,5,6256329548
5564,30202539,24425485,54628024,3,0,1,1024,21,4942330185
5565,30210189,17639423,47849612,3,0,0,13824,21,8811134239
5566,30213860,17466241,47680101,1,0,0,1024,5,2305513032
5567,30229619,24399071,54628690,1,0,1,11264,5,3614488168
5568,30232249,17950363,48182612,3,0,0,11264,21,9317557488
5569,30235851,24445441,54681292,5,0,1,3072,25,800810960
5570,30251450,24429865,54681315,4,0,1,4096,25,3107786456
5571,30256109,24425229,54681338,1,0,1,12288,5,2174433799
5572,30256550,17922607,48179157,5,0,0,223744,25,3693488614
5573,30257029,24430907,54687936,3,0,1,18432,21,9837740484
5574,30259329,17566766,47826095,3,0,0,51200,21,8477439910
5575,30265690,17679175,47944865,8,0,0,51712,1,2385426653
5576,30268930,17715411,47984341,5,0,0,5120,25,8451301948
5577,30269401,24418558,54687959,5,0,1,6144,25,6371315914
5578,30270740,24418459,54689199,6,0,1,4096,17,6569912132
5579,30273289,24416064,54689353,3,0,1,8704,21,4834106824
5580,30274490,17741133,48015623,1,0,0,512,5,10109912585
5581,30279540,17610336,47889876,1,0,0,1024,5,2474374791
5582,30280010,17628237,47908247,1,0,0,512,5,990640067
5583,30280349,24466598,54746947,3,0,1,45568,21,9934269999
5584,30281801,24466452,54748253,7,0,1,2048,21,571557849
5585,30283649,24467681,54751330,1,0,1,2560,5,10451221645
5586,30283889,24467578,54751467,1,0,1,15872,5,3151057717
5587,30284479,24478392,54762871,1,0,1,512,5,1567760409
5588,30289740,17691041,47980781,1,0,0,512,5,2679744706
5589,30302189,24596547,54898736,3,0,1,108544,21,9236176987
5590,30303120,17880326,48183446,1,0,0,512,5,2956087863
5591,30303680,24598672,54902352,0,0,1,16384,8,1474828552
5592,30308710,24594718,54903428,0,0,1,13312,8,7529751938
5593,30312399,24609711,54922110,3,0,1,17408,21,10426828445
5594,30314991,24628186,54943177,5,0,1,3584,25,4971693913
5595,30316119,24627081,54943200,1,0,1,1536,5,8837544743
5596,30318710,17736693,48055403,5,0,0,52736,25,6273643119
5597,30325040,24618183,54943223,2,0,1,1024,19,8142781230
5598,30329839,24613407,54943246,1,0,1,6144,5,7681772400
5599,30331079,24698148,55029227,3,0,1,75776,21,1977058113
5600,30342520,17854544,48197064,5,0,0,10752,25,10628841991
5601,30344859,24781505,55126364,3,0,1,121344,21,8435839944
5602,30348271,24817498,55165769,5,0,1,23552,25,2227128555
5603,30350029,24910641,55260670,3,0,1,71168,21,2661203035
5604,30351389,17893052,48244441,3,0,0,68608,21,6321242374
5605,30354610,17839155,48193765,5,0,0,33792,25,5069700948
5606,30357331,24903362,55260693,5,0,1,8704,25,3999860010
5607,30357890,17656509,48014399,1,0,0,1536,5,7831807759
5608,30358670,17653485,48012155,8,0,0,14336,1,3296861160
5609,30359021,24901695,55260716,5,0,1,1024,25,4199252982
5610,30369439,24891300,55260739,1,0,1,1024,5,580947320
5611,30370441,24890321,55260762,5,0,1,512,25,7365197806
5612,30371089,24889696,55260785,1,0,1,2048,5,9313164014
5613,30373961,24890878,55264839,7,0,1,6656,21,9451254903
5614,30391790,18082047,48473837,8,0,0,43008,1,2010915457
5615,30397600,17702368,48099968,1,0,0,1024,5,7646941658
5616,30398510,17824161,48222671,8,0,0,83968,1,10494231881
5617,30406390,17993652,48400042,8,0,0,24064,1,1558813311
5618,30410550,24867051,55277601,2,0,1,1024,19,4526974774
5619,30416620,24872918,55289538,2,0,1,17408,19,7454228218
5620,30419970,24883930,55303900,2,0,1,1024,19,10073996650
5621,30428849,17754410,48183259,3,0,0,2048,21,6563265808
5622,30433391,24871175,55304566,7,0,1,1024,21,3430525148
5623,30436549,24868273,55304822,3,0,1,9216,21,9283823740
5624,30437609,24894249,55331858,3,0,1,24576,21,5752861236
5625,30437919,24926292,55364211,3,0,1,55808,21,6040012916
5626,30446819,17848799,48295618,3,0,0,33280,21,4026028758
5627,30448479,24922194,55370673,3,0,1,4608,21,5167883621
5628,30450369,24929419,55379788,1,0,1,26112,5,10612520081
5629,30451229,17938003,48389232,3,0,0,86016,21,7008726548
5630,30452650,17770824,48223474,9,0,0,2560,4,1936453312
5631,30459459,24922736,55382195,1,0,1,13312,5,2730940377
5632,30460080,24934274,55394354,2,0,1,16384,19,9570653108
5633,30462760,24938372,55401132,2,0,1,16384,19,2374197360
5634,30463831,24967926,55431757,5,0,1,512,25,6363402911
5635,30464319,24969064,55433383,1,0,1,2560,5,2970464729
5636,30465391,24982246,55447637,7,0,1,4096,21,518360811
5637,30471501,24976802,55448303,5,0,1,1024,25,4495124085
5638,30472209,18288201,48760410,3,0,0,82432,21,1109782384
5639,30473299,25038917,55512216,3,0,1,97792,21,5757289710
5640,30481379,25058619,55539998,3,0,1,17920,21,2094892104
5641,30482460,18032829,48515289,7,0,0,2560,21,4987494660
5642,30490290,25050476,55540766,2,0,1,11776,19,5229307230
5643,30497060,25047135,55544195,2,0,1,3584,19,1474501058
5644,30498579,25061093,55559672,3,0,1,44032,21,5843971957
5645,30502969,25073267,55576236,3,0,1,6656,21,2293776390
5646,30503680,17953795,48457475,5,0,0,37376,25,7885590908
5647,30511151,25075800,55586951,7,0,1,2048,21,2784486539
5648,30514020,17900789,48414809,1,0,0,512,5,5650580105
5649,30517931,25072886,55590817,5,0,1,6144,25,3551547533
5650,30522890,17869797,48392687,8,0,0,11264,1,3301413728
5651,30528700,18157085,48685785,8,0,0,52224,1,2771960851
5652,30532599,25063044,55595643,3,0,1,7680,21,5888642081
5653,30533330,25066663,55599993,2,0,1,3584,19,2382281880
5654,30538121,25063422,55601543,7,0,1,12288,21,476966077
5655,30538330,18129001,48667331,8,0,0,40960,1,4718577358
5656,30540899,25104531,55645430,1,0,1,1536,5,5725688999
5657,30541980,18045150,48587130,5,0,0,87040,25,6739269410
5658,30547809,25097644,55645453,1,0,1,11264,5,10008264433
5659,30548661,25096815,55645476,5,0,1,1024,25,5673765153
5660,30557210,18071551,48628761,8,0,0,15360,1,5806211716
5661,30557699,25173389,55731088,3,0,1,60928,21,3065788402
5662,30563230,25199691,55762921,2,0,1,20992,19,7965516332
5663,30574300,18190368,48764668,8,0,0,13824,1,10377095613
5664,30575771,25217616,55793387,7,0,1,5632,21,7645280251
5665,30582210,18268293,48850503,5,0,0,61952,25,8911866875
5666,30582320,18137920,48720240,5,0,0,34304,25,674320527
5667,30586431,25206987,55793418,7,0,1,2560,21,10570768647
5668,30588030,18081820,48669850,5,0,0,8192,25,2856927137
5669,30595621,25197820,55793441,7,0,1,4608,21,3959792048
5670,30603809,25189655,55793464,3,0,1,7680,21,5171415227
5671,30608930,25184557,55793487,2,0,1,1024,19,771003423
5672,30612469,25181041,55793510,3,0,1,2560,21,6545579005
5673,30614899,25178634,55793533,3,0,1,1024,21,9539270965
5674,30617010,18006546,48623556,1,0,0,512,5,6637136001
5675,30624491,25169065,55793556,5,0,1,7680,25,7107564938
5676,30630159,25163420,55793579,1,0,1,1536,5,2977995869
5677,30634940,18138799,48773739,5,0,0,29696,25,2719658958
5678,30638989,18272632,48911621,3,0,0,20480,21,129307035
5679,30642199,25151403,55793602,3,0,1,512,21,3715113074
5680,30644181,25150932,55795113,7,0,1,3584,21,6026603497
5681,30644569,25151530,55796099,3,0,1,1536,21,2602943185
5682,30654520,18124945,48779465,1,0,0,1024,5,8567492726
5683,30656421,25140024,55796445,7,0,1,512,21,6361553421
5684,30660731,25136060,55796791,5,0,1,512,25,2936348603
5685,30673701,25125996,55799697,5,0,1,4608,25,3959956530
5686,30680039,25121924,55801963,3,0,1,3584,21,7609015369
5687,30680620,18181804,48862424,8,0,0,6656,1,10120927116
5688,30697619,25107250,55804869,1,0,1,4608,5,2036935190
5689,30699199,25106336,55805535,3,0,1,1024,21,318065028
5690,30705619,25102938,55808557,3,0,1,16384,21,9311791330
5691,30712589,25099834,55812423,3,0,1,6144,21,10678174871
5692,30713190,18224778,48937968,8,0,0,4096,1,7321142730
5693,30727470,25087539,55815009,9,0,1,4096,4,1553964485
5694,30729110,18275318,49004428,8,0,0,7168,1,1943034306
5695,30737649,25079626,55817275,1,0,1,3584,5,2526983261
5696,30737979,25080922,55818901,1,0,1,2560,5,5146827728
5697,30743540,25079227,55822767,4,0,1,6144,25,8615771727
5698,30748611,25074502,55823113,7,0,1,512,21,5439012101
5699,30757859,25068800,55826659,3,0,1,5632,21,538640324
5700,30757920,18546684,49304604,5,0,0,128000,25,2468653652
5701,30759031,25105913,55864944,5,0,1,6144,25,1800522369
5702,30761689,25103278,55864967,3,0,1,3584,21,9721201016
5703,30762150,18425156,49187306,1,0,0,512,5,1899642016
5704,30766380,18231999,48998379,8,0,0,71168,1,6108346389
5705,30769080,25095998,55865078,4,0,1,12288,25,8902027562
5706,30771929,25126186,55898115,3,0,1,512,21,9442496012
5707,30808810,18517547,49326357,8,0,0,46592,1,2506284331
5708,30811200,18356045,49167245,5,0,0,72704,25,9389636069
5709,30816770,18281424,49098194,8,0,0,15872,1,8810759055
5710,30820519,25077619,55898138,1,0,1,512,5,493432757
5711,30824401,25074563,55898964,5,0,1,15872,25,3973861118
5712,30827310,25071677,55898987,4,0,1,512,25,7467627416
5713,30830979,25068031,55899010,3,0,1,5120,21,7807092657
5714,30836061,25062972,55899033,7,0,1,2560,21,9183015923
5715,30839390,18235628,49075018,1,0,0,512,5,4805482685
5716,30878990,18485056,49364046,8,0,0,54784,1,6108340323
5717,30881210,25017846,55899056,4,0,1,1536,25,110096417
5718,30882810,18326277,49209087,1,0,0,512,5,3663549641
5719,30884800,25018505,55903305,4,0,1,7680,25,5932905849
5720,30885061,25022110,55907171,5,0,1,6144,25,1432239103
5721,30895449,25019306,55914755,1,0,1,4096,5,9371718906
5722,30908731,25009708,55918439,5,0,1,512,25,606576030
5723,30909979,18402159,49312138,3,0,0,24576,21,2301015924
5724,30914649,18552472,49467121,3,0,0,37888,21,4299112216
5725,30918261,25002124,55920385,5,0,1,3072,25,7630357834
5726,30918860,18504634,49423494,5,0,0,88576,25,8419717665
5727,30922430,18266412,49188842,1,0,0,512,5,7346765991
5728,30929139,18557996,49487135,3,0,0,36864,21,6933843736
5729,30930620,25032158,55962778,0,0,1,42496,8,395422017
5730,30937180,18550454,49487634,1,0,0,1536,5,8874384749
5731,30939939,18535941,49475880,3,0,0,28672,21,4640313468
5732,30948491,25024993,55973484,5,0,1,2560,25,4108619608
5733,30956401,25019669,55976070,5,0,1,4096,25,8095760448
5734,30964481,25011935,55976416,5,0,1,512,25,9025524834
5735,30968190,18546024,49514214,5,0,0,13824,25,5377643575
5736,30969950,25018925,55988875,4,0,1,5632,25,2321105109
5737,30979529,25010652,55990181,3,0,1,2048,21,7170686252
5738,30980279,25024657,56004936,3,0,1,5120,21,921768502
5739,30981649,25024593,56006242,3,0,1,2048,21,3675051712
5740,30981750,25045545,56027295,0,0,1,27136,8,8072874171
5741,30985670,25089334,56075004,4,0,1,1024,25,9746839260
5742,30986600,25088435,56075035,0,0,1,16384,8,3349671824
5743,30991011,25086820,56077831,7,0,1,5120,21,664469027
5744,30991161,25087336,56078497,5,0,1,1024,25,7958626175
5745,30991860,18612286,49604146,1,0,0,512,5,5704319534
5746,30998390,18388382,49386772,8,0,0,33280,1,8942506168
5747,31004959,25076764,56081723,1,0,1,5120,5,5832350814
5748,31010150,18316698,49326848,8,0,0,1536,1,3706578964
5749,31012710,25069359,56082069,4,0,1,512,25,8424876515
5750,31018099,25064738,56082837,3,0,1,11776,21,5392251037
5751,31018749,25098803,56117552,3,0,1,3072,21,920797173
5752,31027030,25090545,56117575,4,0,1,8704,25,4770486267
5753,31044760,25073182,56117942,4,0,1,512,25,3197664622
5754,31057460,18571558,49629018,8,0,0,44544,1,7636849011
5755,31065029,25053259,56118288,3,0,1,512,21,1073116138
5756,31072660,25058814,56131474,0,0,1,54784,8,151594610
5757,31077490,18353819,49431309,1,0,0,1024,5,7292781778
5758,31079380,18513920,49593300,8,0,0,35328,1,924420653
5759,31080571,25101161,56181732,5,0,1,4096,25,8834855852
5760,31086350,18690491,49776841,5,0,0,39424,25,6683161410
5761,31093289,25088466,56181755,3,0,1,4608,21,5686491382
5762,31093490,25088288,56181778,4,0,1,3584,25,2203723481
5763,31094651,25089312,56183963,5,0,1,3584,25,9302055943
5764,31102970,25130671,56233641,0,0,1,51712,8,5804459213
5765,31104161,25178049,56282210,5,0,1,4096,25,340706112
5766,31112231,25172071,56284302,5,0,1,6144,25,2549379808
5767,31117560,18956584,50074144,5,0,0,39424,25,1254232241
5768,31122390,18451228,49573618,5,0,0,512,25,7375456707
5769,31125500,18475040,49600540,1,0,0,2048,5,6833519050
5770,31135410,25226325,56361735,0,0,1,71168,8,1014709536
5771,31140761,25220997,56361758,5,0,1,10752,25,6224662963
5772,31140790,25243322,56384112,0,0,1,27136,8,4698025508
5773,31141360,18805399,49946759,8,0,0,67584,1,6892250338
5774,31141720,18599692,49741412,5,0,0,28160,25,7720943118
5775,31159560,18559491,49719051,1,0,0,1024,5,10192903706
5776,31167420,18558890,49726310,8,0,0,2048,1,564356313
5777,31169650,18642502,49812152,1,0,0,1024,5,10502387968
5778,31172350,18801410,49973760,8,0,0,44032,1,2414634581
5779,31180679,25203464,56384143,1,0,1,3072,5,3152264174
5780,31181920,25202246,56384166,4,0,1,1536,25,9698372018
5781,31184401,25199788,56384189,5,0,1,512,25,624726379
5782,31191469,25215082,56406551,3,0,1,16896,21,2530980310
5783,31197949,25208625,56406574,1,0,1,512,5,2699120165
5784,31206350,25207446,56413796,4,0,1,6144,25,6826752985
5785,31207350,18892258,50099608,8,0,0,32256,1,3531349929
5786,31207410,19125962,50333372,5,0,0,230912,25,1671705066
5787,31211971,25201848,56413819,5,0,1,512,25,7888946916
5788,31218049,25195793,56413842,1,0,1,3584,5,7482773089
5789,31222539,25206357,56428896,3,0,1,6656,21,3499339296
5790,31231929,25229841,56461770,3,0,1,9216,21,821549615
5791,31234200,25231204,56465404,4,0,1,2560,25,1602225153
5792,31235719,25229708,56465427,1,0,1,7168,5,7102159812
5793,31236361,25229089,56465450,5,0,1,7168,25,8453257355
5794,31237310,18930836,50168146,8,0,0,72704,1,7260547229
5795,31242720,18966633,50209353,5,0,0,135168,25,9365230344
5796,31254829,25211336,56466165,1,0,1,7168,5,7507755968
5797,31256970,18884253,50141223,1,0,0,3072,5,8931569073
5798,31257230,25220164,56477394,0,0,1,12800,8,1969933571
5799,31257860,25222834,56480694,6,0,1,2560,17,4014235344
5800,31260850,19158888,50419738,8,0,0,71168,1,8908758515
5801,31265509,25216491,56482000,1,0,1,2048,5,4609118692
5802,31267560,18989272,50256832,5,0,0,12800,25,475213175
5803,31277270,25208276,56485546,6,0,1,5632,17,8668565327
5804,31295880,19053611,50349491,5,0,0,52224,25,2988511937
5805,31297420,25191701,56489121,4,0,1,8704,25,8615760886
5806,31302300,25189727,56492027,4,0,1,4608,25,7655025226
5807,31306310,25188943,56495253,6,0,1,5120,17,496695540
5808,31308150,19043617,50351767,8,0,0,7168,1,5537100614
5809,31314540,19070409,50384949,5,0,0,9728,25,5840414173
5810,31314840,25182999,56497839,6,0,1,4096,17,6696597043
5811,31316340,25195479,56511819,4,0,1,1536,25,4830161905
5812,31322490,25193835,56516325,4,0,1,7168,25,10190574337
5813,31324990,25247612,56572602,4,0,1,19456,25,8481547895
5814,31327971,25255149,56583120,5,0,1,3584,25,655150299
5815,31328340,19345028,50673368,8,0,0,18432,1,1173576093
5816,31330591,25266617,56597208,5,0,1,35328,25,5342393744
5817,31335100,19293003,50628103,8,0,0,93696,1,5663270123
5818,31337130,25267905,56605035,6,0,1,512,17,10337501149
5819,31341509,25263782,56605291,1,0,1,9216,5,10118715657
5820,31346709,25271223,56617932,3,0,1,1024,21,7591723177
5821,31355159,25266959,56622118,3,0,1,6656,21,1875102255
5822,31355531,25278033,56633564,5,0,1,46080,25,8208459927
5823,31359569,25283998,56643567,1,0,1,1024,5,8682212919
5824,31363891,25280956,56644847,5,0,1,14336,25,6528491672
5825,31364841,25417045,56781886,5,0,1,31232,25,1078778154
5826,31365079,25416830,56781909,1,0,1,12288,5,8486363704
5827,31366090,25415842,56781932,2,0,1,2048,19,7499689515
5828,31368391,25413628,56782019,5,0,1,20992,25,1276740493
5829,31376700,19333770,50710470,8,0,0,96256,1,10580187188
5830,31380760,19016484,50397244,1,0,0,1536,5,700370683
5831,31386590,19090391,50476981,5,0,0,25600,25,4670946730
5832,31392101,25421027,56813128,5,0,1,10752,25,9533634108
5833,31406451,25473763,56880214,5,0,1,60416,25,3317141857
5834,31410631,25670944,57081575,5,0,1,49664,25,5678503952
5835,31418281,25675105,57093386,5,0,1,15872,25,6827585811
5836,31426741,25986485,57413226,5,0,1,130560,25,8133020934
5837,31428220,19239486,50667706,5,0,0,13824,25,3632306160
5838,31430710,19232761,50663471,8,0,0,26624,1,5376943123
5839,31447829,25983383,57431212,1,0,1,4096,5,6226316205
5840,31448071,25983164,57431235,7,0,1,3584,21,7059870912
5841,31453580,25977678,57431258,6,0,1,11264,17,5117599124
5842,31477780,19297616,50775396,5,0,0,64512,25,8631635343
5843,31478850,19239081,50717931,1,0,0,1536,5,188698514
5844,31484271,25947010,57431281,5,0,1,26112,25,10456307269
5845,31490430,19189954,50680384,1,0,0,512,5,8276601601
5846,31490520,25942539,57433059,9,0,1,1536,4,159609213
5847,31508140,19361010,50869150,5,0,0,55808,25,8157744484
5848,31517700,19193261,50710961,1,0,0,1536,5,8507213611
5849,31520560,19211291,50731851,8,0,0,8192,1,6684932704
5850,31524900,19557035,51081935,8,0,0,31744,1,6313257288
5851,31530279,25902803,57433082,8,0,1,1536,1,5199332
5852,31533820,25899776,57433596,9,0,1,6656,4,10336636585
5853,31538360,19366201,50904561,5,0,0,11264,25,1654477453
5854,31539140,25894503,57433643,9,0,1,5120,4,6617563066
5855,31543450,25891212,57434662,6,0,1,2048,17,2069734967
5856,31549870,19370986,50920856,1,0,0,512,5,8067283290
5857,31560800,19346280,50907080,8,0,0,8192,1,10065788889
5858,31574550,19356438,50930988,8,0,0,7168,1,4818076131
5859,31577300,19477848,51055148,1,0,0,3584,5,3958713239
5860,31589550,25858710,57448260,2,0,1,2560,19,9421712370
5861,31597621,25851625,57449246,7,0,1,1536,21,3040003532
5862,31602440,19522023,51124463,5,0,0,12800,25,1632544383
5863,31608530,25842304,57450834,2,0,1,15872,19,3370833982
5864,31615031,25903872,57518903,7,0,1,512,21,9831755974
5865,31621679,25897247,57518926,8,0,1,8192,1,10405304393
5866,31624260,25900016,57524276,2,0,1,3584,19,503860669
5867,31625699,25898600,57524299,8,0,1,1024,1,7000307568
5868,31631510,25892812,57524322,2,0,1,2048,19,7705665574
5869,31632470,19296311,50928781,8,0,0,25088,1,549874099
5870,31634140,25890205,57524345,6,0,1,2560,17,9654737964
5871,31635890,25888478,57524368,6,0,1,2048,17,2183756416
5872,31637760,25889774,57527534,6,0,1,2048,17,1755011727
5873,31637950,25889607,57527557,2,0,1,18432,19,1080769538
5874,31644130,25883458,57527588,6,0,1,6656,17,6206050575
5875,31648510,19386104,51034614,5,0,0,27136,25,4678345679
5876,31655789,25871838,57527627,8,0,1,1024,1,10086596792
5877,31663590,25864060,57527650,2,0,1,4096,19,3865778150
5878,31666610,19329453,50996063,5,0,0,13824,25,5456975875
5879,31669580,19381996,51051576,8,0,0,1024,1,1788770819
5880,31671020,19716446,51387466,8,0,0,70656,1,6219659187
5881,31678431,25857151,57535582,7,0,1,4096,21,1309039019
5882,31681471,25857337,57538808,7,0,1,5120,21,8211504416
5883,31684750,25865214,57549964,2,0,1,8192,19,6093892047
5884,31690339,25861251,57551590,8,0,1,2560,1,8934625275
5885,31696531,25856237,57552768,7,0,1,13824,21,2514872764
5886,31704419,25864860,57569279,3,0,1,3072,21,5865981971
5887,31704620,19603144,51307764,1,0,0,512,5,7801070853
5888,31712871,25858354,57571225,7,0,1,3072,21,1131777243
5889,31715640,19759282,51474922,1,0,0,2560,5,3445578226
5890,31722940,19716120,51439060,5,0,0,92672,25,13191668
5891,31733860,25838351,57572211,2,0,1,1536,19,5780289927
5892,31735660,20212950,51948610,1,0,0,512,5,5473533972
5893,31737570,19476126,51213696,1,0,0,1536,5,3414760460
5894,31745539,25827018,57572557,8,0,1,512,1,4767389462
5895,31749150,25825033,57574183,2,0,1,2560,19,7698064996
5896,31757049,25819780,57576829,3,0,1,11776,21,9042116880
5897,31760440,20097866,51858306,0,0,0,111616,8,1431870679
5898,31769141,25821295,57590436,7,0,1,7168,21,10337563769
5899,31788150,25803912,57592062,2,0,1,2560,19,654924646
5900,31812110,19381143,51193253,1,0,0,512,5,7861024371
5901,31850550,19880958,51731508,8,0,0,92160,1,1749225300
5902,31850730,25741678,57592408,2,0,1,512,19,2272159566
5903,31852000,20803803,52655803,8,0,0,17920,1,7895353330
5904,31863249,25729505,57592754,3,0,1,512,21,3246492040
5905,31864220,19523581,51387801,1,0,0,1024,5,3136624327
5906,31870640,25728015,57598655,2,0,1,19968,19,770735286
5907,31898190,19666858,51565048,8,0,0,90112,1,8819721689
5908,31899990,25729064,57629054,9,0,1,5120,4,4906342053
5909,31901310,25730650,57631960,9,0,1,4608,4,6600774610
5910,31920539,25714967,57635506,3,0,1,5632,21,1489159728
5911,31929249,25710466,57639715,3,0,1,3072,21,7476485603
5912,31942259,25698592,57640851,3,0,1,1536,21,1982889387
5913,31942860,20139566,52082426,5,0,0,164864,25,10673769784
5914,31945730,19977737,51923467,5,0,0,25088,25,3671591757
5915,31947800,25693717,57641517,9,0,1,1024,4,9687499675
5916,31951110,19553460,51504570,5,0,0,35328,25,3028721670
5917,31953250,19707460,51660710,8,0,0,7680,1,502188877
5918,31968520,19838086,51806606,5,0,0,20480,25,8583642420
5919,31970300,20565361,52535661,5,0,0,10240,25,8232334570
5920,31971480,25674543,57646023,9,0,1,7168,4,9083992953
5921,31977710,25672819,57650529,9,0,1,7168,4,3197345252
5922,31978960,19471896,51450856,5,0,0,20480,25,6158276071
5923,31981190,25675194,57656384,9,0,1,2560,4,1356647898
5924,31982330,25674208,57656538,4,0,1,8704,25,6182954287
5925,31991920,25665604,57657524,4,0,1,1536,25,3073819146
5926,31992490,19482920,51475410,1,0,0,512,5,316812929
5927,31994050,19514984,51509034,8,0,0,4608,1,7359156991
5928,31998840,25659030,57657870,9,0,1,512,4,2515191904
5929,32000460,20804653,52805113,5,0,0,79360,25,7319541627
5930,32000579,25658277,57658856,1,0,1,1536,5,10607846217
5931,32016870,25654815,57671685,9,0,1,12288,4,178797184
5932,32022070,19506300,51528370,1,0,0,1536,5,7871190512
5933,32025230,25657162,57682392,4,0,1,12288,25,5587495162
5934,32036230,19494478,51530708,5,0,0,1536,25,5310776536
5935,32048890,25648180,57697070,9,0,1,11776,4,3293430327
5936,32071460,25628196,57699656,9,0,1,4096,4,2615890590
5937,32078890,25621112,57700002,9,0,1,512,4,1857152167
5938,32091339,25612849,57704188,8,0,1,6656,1,6575949154
5939,32091890,25615204,57707094,9,0,1,4608,4,4148052167
5940,32101360,19492944,51594304,5,0,0,35328,25,7790184111
5941,32101890,19364728,51466618,1,0,0,512,5,1516854249
5942,32107790,19626198,51733988,1,0,0,1024,5,9059745498
5943,32128000,25579760,57707760,9,0,1,1024,4,6273252122
5944,32128720,19510656,51639376,1,0,0,16896,5,5838535645
5945,32131529,25577857,57709386,8,0,1,2560,1,3396926418
5946,32132320,25581892,57714212,9,0,1,7680,4,3842941038
5947,32136790,19566592,51703382,1,0,0,32768,5,248690332
5948,32143400,25573718,57717118,9,0,1,4608,4,5672289600
5949,32144490,19679138,51823628,1,0,0,53248,5,7430470501
5950,32154670,25565674,57720344,9,0,1,5120,4,10727043414
5951,32162670,20734617,52897287,8,0,0,34816,1,8706599123
5952,32169210,25553720,57722930,4,0,1,4096,25,9972330984
5953,32171869,25553007,57724876,3,0,1,3072,21,8465350527
5954,32172419,25555043,57727462,8,0,1,4096,1,5126250631
5955,32180320,25547488,57727808,3,0,1,512,21,9957391638
5956,32188689,25539465,57728154,8,0,1,512,1,6900639030
5957,32192300,25536110,57728410,9,0,1,9216,4,5729429797
5958,32194890,19589302,51784192,1,0,0,61440,5,8795106275
5959,32199300,19367019,51566319,5,0,0,4096,25,7665437494
5960,32212470,25571005,57783475,9,0,1,10240,4,1171770013
5961,32214190,25584943,57799133,9,0,1,3072,4,4584261527
5962,32216840,19794524,52011364,5,0,0,144384,25,5789700406
5963,32228809,25572270,57801079,8,0,1,3072,1,3603748734
5964,32230939,25572726,57803665,8,0,1,4096,1,8172432183
5965,32236959,25569932,57806891,8,0,1,5120,1,3042436196
5966,32242129,25578142,57820271,8,0,1,2048,1,4075569962
5967,32242599,25578018,57820617,8,0,1,512,1,9036527658
5968,32246880,19428174,51675054,1,0,0,17920,5,9224572648
5969,32263300,19872709,52136009,1,0,0,37376,5,4825715757
5970,32263470,25557493,57820963,9,0,1,512,4,1935240464
5971,32266819,25555130,57821949,8,0,1,1536,1,6250653429
5972,32270020,25555155,57825175,6,0,1,5120,17,6233218371
5973,32271860,19676016,51947876,8,0,0,6144,1,10721444715
5974,32272490,19643310,51915800,1,0,0,40960,5,522599123
5975,32280030,19884596,52164626,5,0,0,14848,25,10022921968
5976,32288270,19572663,51860933,1,0,0,7168,5,5172788568
5977,32288900,19871156,52160056,8,0,0,78848,1,3493667925
5978,32291740,25535381,57827121,2,0,1,3072,19,4326537497
5979,32293450,25535617,57829067,9,0,1,3072,4,2143534790
5980,32296169,25780517,58076686,8,0,1,3584,1,8752121440
5981,32300160,25784790,58084950,6,0,1,3584,17,1383307724
5982,32303220,19863769,52166989,1,0,0,7680,5,6291935793
5983,32314470,19806429,52120899,1,0,0,5120,5,9444746124
5984,32344250,25757579,58101829,9,0,1,2560,4,10398158996
5985,32348260,20013194,52361454,8,0,0,86528,1,3975256892
5986,32353330,19936997,52290327,5,0,0,25088,25,9698798529
5987,32353880,19763170,52117050,1,0,0,19456,5,6954599467
5988,32353900,19883261,52237161,1,0,0,28160,5,4777753037
5989,32360500,19671617,52032117,8,0,0,28160,1,1177675426
5990,32366960,19503707,51870667,8,0,0,2048,1,6762429350
5991,32367540,19655882,52023422,8,0,0,512,1,8488348190
5992,32371160,25731655,58102815,9,0,1,1536,4,165436234
5993,32388310,20112638,52500948,8,0,0,512,1,1268475399
5994,32393410,19430865,51824275,5,0,0,2048,25,9769731526
5995,32401200,19457441,51858641,8,0,0,1024,1,8405421095
5996,32413210,25689951,58103161,9,0,1,512,4,633306930
5997,32414851,20275259,52690110,2,0,0,28160,19,203975966
5998,32415540,19607703,52023243,1,0,0,38912,5,9570598971
5999,32420370,25684417,58104787,9,0,1,2560,4,7174335619
6000,32422920,19450917,51873837,8,0,0,512,1,1415729181
6001,32423970,19372856,51796826,8,0,0,512,1,2700843615
6002,32425500,25707174,58132674,9,0,1,5632,4,3299887871
6003,32433490,20325978,52759468,1,0,0,52224,5,4930756840
6004,32435810,25696887,58132697,9,0,1,512,4,9506601041
6005,32437690,19748671,52186361,1,0,0,31232,5,1584729122
6006,32450540,25682180,58132720,3,0,1,512,21,436035663
6007,32462190,20386717,52848907,1,0,0,20992,5,86456134
6008,32465710,19395402,51861112,8,0,0,512,1,7438854700
6009,32482299,25728159,58210458,3,0,1,8704,21,3057351124
6010,32496550,25728173,58224723,9,0,1,6144,4,5538955890
6011,32508710,20547727,53056437,1,0,0,126976,5,10350089579
6012,32537079,25687683,58224762,3,0,1,6656,21,4082247966
6013,32561510,25863534,58425044,9,0,1,3072,4,7793202264
6014,32564950,25864920,58429870,9,0,1,7680,4,5462747594
6015,32565340,25902531,58467871,4,0,1,5632,25,9932088769
6016,32573210,25894684,58467894,9,0,1,8704,4,317375293
6017,32576920,19599766,52176686,8,0,0,1536,1,333809869
6018,32588291,25879626,58467917,7,0,1,2048,21,2905872452
6019,32594580,26039944,58634524,4,0,1,8192,25,2730202330
6020,32595369,26039178,58634547,3,0,1,512,21,4627510302
6021,32596100,19612515,52208615,1,0,0,22016,5,4445614207
6022,32602420,19591329,52193749,1,0,0,11776,5,6740129830
6023,32603420,26031150,58634570,9,0,1,13824,4,5822195644
6024,32608760,26064777,58673537,9,0,1,2560,4,5345434302
6025,32610070,19472902,52082972,1,0,0,1536,5,3161412329
6026,32616641,26074640,58691281,5,0,1,36864,25,9727145849
6027,32620981,26124383,58745364,7,0,1,16384,21,7551057188
6028,32621491,26125819,58747310,7,0,1,3072,21,4951238537
6029,32624670,26124266,58748936,9,0,1,2560,4,1663341438
6030,32630760,26137636,58768396,4,0,1,6656,25,4787761432
6031,32634290,19698064,52332354,8,0,0,512,1,6293570771
6032,32640760,19878173,52518933,5,0,0,46080,25,4240218575
6033,32643670,26124749,58768419,9,0,1,512,4,3908241519
6034,32649600,26128693,58778293,9,0,1,10240,4,9316406123
6035,32655280,26127199,58782479,4,0,1,6656,25,9992104291
6036,32656529,26134962,58791491,3,0,1,14336,21,9585021904
6037,32662220,26152420,58814640,4,0,1,7168,25,6375249976
6038,32663420,19770787,52434207,8,0,0,1024,1,5154006513
6039,32670350,26145916,58816266,9,0,1,2560,4,3720292360
6040,32672980,26143952,58816932,4,0,1,1024,25,7680736608
6041,32680590,19682807,52363397,5,0,0,1024,25,2011434824
6042,32686160,19481169,52167329,5,0,0,512,25,5639131350
6043,32701199,26117359,58818558,3,0,1,2560,21,9542361824
6044,32701770,26132967,58834737,4,0,1,4096,25,3965225800
6045,32705870,26128890,58834760,4,0,1,4096,25,1542480642
6046,32708430,19616416,52324846,8,0,0,512,1,7043680402
6047,32719719,26115064,58834783,3,0,1,9728,21,7122396635
6048,32723620,19485642,52209262,8,0,0,2048,1,4772866468
6049,32724489,26130836,58855325,3,0,1,6656,21,3613940625
6050,32724610,19637420,52362030,8,0,0,1536,1,9468569618
6051,32724660,19925317,52649977,1,0,0,45568,5,2043403461
6052,32725110,26230987,58956097,4,0,1,30208,25,9877211959
6053,32733810,19985768,52719578,1,0,0,38912,5,10670650663
6054,32736691,26242863,58979554,7,0,1,6656,21,6485296228
6055,32752449,26230011,58982460,3,0,1,4608,21,536160965
6056,32756950,19965615,52722565,5,0,0,9728,25,9160502783
6057,32791670,20031874,52823544,1,0,0,60416,5,5866277942
6058,32796920,26187486,58984406,9,0,1,3072,4,1171412196
6059,32801929,20027878,52829807,3,0,0,20480,21,1098324903
6060,32813620,19852346,52665966,1,0,0,33280,5,10463193949
6061,32817600,20087982,52905582,8,0,0,1536,1,9393390106
6062,32825231,26191917,59017148,7,0,1,1536,21,7960137874
6063,32827479,26189692,59017171,3,0,1,3584,21,2098257001
6064,32829391,26187803,59017194,7,0,1,512,21,9228286062
6065,32836140,20050516,52886656,1,0,0,30720,5,6476208729
6066,32838260,19797810,52636070,5,0,0,81408,25,9209066844
6067,32838550,20176636,53015186,1,0,0,50688,5,3080458472
6068,32845090,20494032,53339122,8,0,0,512,1,5901361894
6069,32847190,19633040,52480230,5,0,0,15360,25,3929548348
6070,32869490,26323333,59192823,0,0,1,39424,8,4680146567
6071,32874270,26465256,59339526,9,0,1,114176,4,8941482292
6072,32885820,20050159,52935979,8,0,0,2048,1,1938061117
6073,32900650,19879901,52780551,5,0,0,69120,25,6394671226
6074,32906539,26480953,59387492,3,0,1,7680,21,1251135248
6075,32909820,19767952,52677772,8,0,0,1024,1,2583143061
6076,32925350,19805678,52731028,1,0,0,24576,5,844223106
6077,32935040,20132174,53067214,5,0,0,25600,25,1070672139
6078,32938280,19550849,52489129,8,0,0,1536,1,4958630704
6079,32947830,19748699,52696529,1,0,0,20992,5,1112420277
6080,32955371,19876807,52832178,2,0,0,7680,19,4433244456
6081,32968530,20164483,53133013,1,0,0,25600,5,1064096986
6082,32984020,26557210,59541230,9,0,1,78848,4,10679058676
6083,32996510,20107730,53104240,5,0,0,116224,25,3314636815
6084,33021900,20240176,53262076,5,0,0,152064,25,7192767079
6085,33030940,26521880,59552820,9,0,1,5632,4,713916933
6086,33032409,26520434,59552843,1,0,1,2560,5,6942865892
6087,33051910,20071354,53123264,8,0,0,512,1,1361906386
6088,33066950,26485916,59552866,6,0,1,1024,17,6187166030
6089,33070690,19762026,52832716,8,0,0,1536,1,10269121562
6090,33077580,26475309,59552889,6,0,1,512,17,6437307114
6091,33080660,26479833,59560493,9,0,1,62976,4,8661993878
6092,33081560,19699326,52780886,8,0,0,1024,1,7646581201
6093,33104720,26472434,59577154,9,0,1,29696,4,2676909593
6094,33105690,20180751,53286441,1,0,0,33792,5,4790565567
6095,33106410,26475002,59581412,9,0,1,26112,4,9954664676
6096,33111840,26484882,59596722,9,0,1,3072,4,10166182644
6097,33117370,26540688,59658058,9,0,1,54784,4,7016537666
6098,33118260,26554687,59672947,6,0,1,8704,17,5464699920
6099,33129970,26557356,59687326,6,0,1,16896,17,8057224030
6100,33131280,20375069,53506349,5,0,0,63488,25,8720172304
6101,33131740,19851264,52983004,1,0,0,57856,5,3940678266
6102,33152780,26541670,59694450,9,0,1,5120,4,3668109930
6103,33161130,19800081,52961211,5,0,0,47616,25,3697527718
6104,33186280,26508193,59694473,6,0,1,3072,17,2490841299
6105,33187080,26508004,59695084,6,0,1,4096,17,1059541772
6106,33199510,26547961,59747471,9,0,1,52224,4,6482946082
6107,33206180,26552347,59758527,9,0,1,43520,4,4157522886
6108,33232920,19506252,52739172,8,0,0,1536,1,10520931582
6109,33263380,19736339,52999719,5,0,0,54784,25,9359082931
6110,33269890,26700142,59970032,9,0,1,134656,4,919570619
6111,33271920,19584098,52856018,8,0,0,512,1,2853235046
6112,33274490,20001608,53276098,1,0,0,45568,5,8281240203
6113,33287120,26682935,59970055,6,0,1,2560,17,5425473547
6114,33289860,19614381,52904241,8,0,0,512,1,7602566621
6115,33293360,19372801,52666161,8,0,0,512,1,6195479328
6116,33294170,26702493,59996663,9,0,1,23552,4,2723815440
6117,33302170,26777574,60079744,9,0,1,52736,4,1991750993
6118,33312360,20173897,53486257,5,0,0,65536,25,1072171162
6119,33319280,26768374,60087654,6,0,1,12288,17,8591340078
6120,33323811,26800051,60123862,5,0,1,17920,25,4726936041
6121,33328960,19960124,53289084,8,0,0,512,1,5474369193
6122,33369479,26754414,60123893,6,0,1,2048,17,10638641053
6123,33376310,20023925,53400235,5,0,0,49664,25,8466352214
6124,33383510,19675758,53059268,5,0,0,9216,25,8607658876
6125,33386850,19263462,52650312,5,0,0,1024,25,8901563144
6126,33389039,26734888,60123927,6,0,1,9728,17,249204132
6127,33392700,26737449,60130149,9,0,1,29184,4,2313053244
6128,33412709,19710353,53123062,3,0,0,56832,21,10387835996
6129,33415020,19317696,52732716,8,0,0,512,1,8279212806
6130,33417770,26758361,60176131,9,0,1,20480,4,1051530735
6131,33436949,26755236,60192185,6,0,1,4096,17,10457131913
6132,33442560,19753185,53195745,5,0,0,23552,25,9792166717
6133,33453679,26747958,60201637,6,0,1,7680,17,873115069
6134,33478239,26724585,60202824,6,0,1,1024,17,7011443471
6135,33509739,26708869,60218608,6,0,1,10752,17,2355668788
6136,33521020,19584703,53105723,5,0,0,4608,25,429168251
6137,33524730,20163837,53688567,8,0,0,512,1,4419890934
6138,33530581,26873494,60404075,5,0,1,144384,25,7087967077
6139,33550899,26867278,60418177,6,0,1,18944,17,9156110251
6140,33555620,19460149,53015769,8,0,0,1536,1,3608575593
6141,33556871,26904185,60461056,5,0,1,87040,25,562839748
6142,33558341,26918669,60477010,5,0,1,13824,25,9221996689
6143,33566860,19557987,53124847,5,0,0,5120,25,5134099613
6144,33572860,19495937,53068797,5,0,0,5120,25,3298537188
6145,33575360,19613146,53188506,5,0,0,75264,25,5510552897
6146,33580560,20025410,53605970,8,0,0,512,1,4690255090
6147,33587171,26890505,60477676,5,0,1,1024,25,2028854876
6148,33588869,26889153,60478022,6,0,1,512,17,5725925810
6149,33592171,26887388,60479559,5,0,1,23552,25,4734288230
6150,33593460,19602776,53196236,8,0,0,1536,1,745185127
6151,33598329,26888553,60486882,1,0,1,5120,5,4496376338
6152,33604309,26891156,60495465,1,0,1,8704,5,2829351765
6153,33605250,26921449,60526699,9,0,1,9216,4,10417406325
6154,33613039,26923181,60536220,6,0,1,10752,17,9521312845
6155,33626531,26923439,60549970,5,0,1,46592,25,5271537517
6156,33639959,26910357,60550316,3,0,1,512,21,656958432
6157,33641570,26909412,60550982,9,0,1,1024,4,1225065731
6158,33647970,26909580,60557550,9,0,1,31232,4,5805210486
6159,33652109,26928773,60580882,1,0,1,5632,5,7158420690
6160,33662300,19824604,53486904,8,0,0,2048,1,3567242313
6161,33662541,26978226,60640767,5,0,1,60928,25,2500950975
6162,33664999,26984228,60649227,3,0,1,1536,21,3026577877
6163,33665049,26986124,60651173,1,0,1,3072,5,6475338020
6164,33665659,26997799,60663458,3,0,1,2048,21,3619544435
6165,33674500,26988981,60663481,9,0,1,3072,4,4715057515
6166,33681510,19443680,53125190,8,0,0,1024,1,4568026679
6167,33702850,26961269,60664119,9,0,1,1536,4,8260651919
6168,33708909,26959742,60668651,6,0,1,7168,17,3340020562
6169,33722039,26948238,60670277,1,0,1,2560,5,9904535935
6170,33722270,20172774,53895044,5,0,0,70144,25,6702507959
6171,33724280,19472135,53196415,8,0,0,512,1,9487472750
6172,33733080,26937863,60670943,2,0,1,1024,19,6879794954
6173,33735539,26937752,60673291,3,0,1,3072,21,2273810368
6174,33737060,26938177,60675237,4,0,1,3072,25,6235251718
6175,33738799,26939344,60678143,6,0,1,4608,17,9802347964
6176,33743169,26940146,60683315,3,0,1,8192,21,6452836017
6177,33743339,26945122,60688461,6,0,1,8192,17,9933986293
6178,33743949,26944858,60688807,6,0,1,512,17,1460055046
6179,33749119,26940034,60689153,6,0,1,512,17,3794264822
6180,33751529,26941490,60693019,6,0,1,6144,17,8376073947
6181,33753149,26962226,60715375,1,0,1,13824,5,8084481497
6182,33754739,26986827,60741566,1,0,1,2560,5,10401931939
6183,33757029,26985850,60742879,3,0,1,14336,21,5582137867
6184,33771059,26976006,60747065,3,0,1,6656,21,8377639883
6185,33780610,27009766,60790376,9,0,1,45568,4,365969055
6186,33783770,20232835,54016605,5,0,0,119296,25,5280674347
6187,33787629,27019537,60807166,3,0,1,7680,21,7953322065
6188,33796269,27013483,60809752,3,0,1,4096,21,10439137694
6189,33801149,27009589,60810738,1,0,1,1536,5,2613715413
6190,33805409,27021066,60826475,6,0,1,5120,17,9999867002
6191,33814780,19837655,53652435,8,0,0,512,1,8604267893
6192,33827379,26999442,60826821,3,0,1,512,21,4645515338
6193,33854469,27004074,60858543,6,0,1,16896,17,2552570258
6194,33854689,27013235,60867924,1,0,1,2048,5,4268749284
6195,33879469,26991361,60870830,6,0,1,4608,17,962497748
6196,33887559,27003428,60890987,6,0,1,11776,17,6321243695
6197,33894980,27127425,61022405,9,0,1,107008,4,5720448312
6198,33900239,27135191,61035430,3,0,1,4608,21,8263583681
6199,33903239,27132214,61035453,6,0,1,12800,17,4344323711
6200,33908410,19856660,53765070,6,0,0,77312,17,153018389
6201,33910749,27130007,61040756,3,0,1,2560,21,6473816536
6202,33910999,27145007,61056006,6,0,1,512,17,9719276836
6203,33913229,27142800,61056029,6,0,1,10240,17,6056785032
6204,33915210,19550887,53466097,5,0,0,68096,25,9776139689
6205,33919249,27138705,61057954,3,0,1,1024,21,9664261047
6206,33919520,19848381,53767901,5,0,0,9216,25,7620242549
6207,33921470,19501407,53422877,8,0,0,1024,1,9607147731
6208,33922119,27153954,61076073,6,0,1,13312,17,8054546065
6209,33926210,19680251,53606461,8,0,0,1536,1,10323792283
6210,33930369,27155868,61086237,3,0,1,5632,21,7633637447
6211,33936440,19778179,53714619,8,0,0,512,1,887901246
6212,33939640,27151411,61091051,9,0,1,20992,4,4504981599
6213,33940100,19728697,53668797,6,0,0,17408,17,1852871382
6214,33946171,27150699,61096870,7,0,1,5120,21,8126795148
6215,33949369,27165404,61114773,3,0,1,1024,21,1722873781
6216,33949519,27166907,61116426,3,0,1,13824,21,8311539888
6217,33950251,27188554,61138805,7,0,1,22016,21,8477638091
6218,33953960,19979327,53933287,5,0,0,125440,25,2152312405
6219,33958570,27254166,61212736,9,0,1,23552,4,5021678457
6220,33968100,27252877,61220977,2,0,1,2560,19,8814660201
6221,33969670,19589657,53559327,6,0,0,9728,17,9668304215
6222,33976290,19977487,53953777,6,0,0,41472,17,7178279642
6223,33979590,20000644,53980234,8,0,0,512,1,8212987275
6224,33992629,27228371,61221000,6,0,1,512,17,2399991396
6225,33993610,27271903,61265513,9,0,1,40448,4,6716318464
6226,33997910,19510628,53508538,1,0,0,3584,5,2703445077
6227,33998831,27269749,61268580,7,0,1,1536,21,9453765207
6228,34000890,27270276,61271166,2,0,1,4096,19,2796186878
6229,34000930,19604861,53605791,5,0,0,18432,25,9045894627
6230,34004309,27286302,61290611,6,0,1,512,17,6403438865
6231,34019739,27282414,61302153,3,0,1,4608,21,10321268327
6232,34021539,27280637,61302176,1,0,1,3072,5,9183072065
6233,34022170,19784066,53806236,8,0,0,512,1,6991285038
6234,34028610,27273589,61302199,2,0,1,10240,19,6944849212
6235,34031370,27281543,61312913,9,0,1,9728,4,1943986689
6236,34034830,27437332,61472162,9,0,1,186368,4,3513732497
6237,34037359,27465030,61502389,3,0,1,3584,21,8290798824
6238,34038919,27468962,61507881,3,0,1,8704,21,6078683350
6239,34040540,19939515,53980055,5,0,0,74752,25,1272830706
6240,34048999,27493066,61542065,1,0,1,2048,5,466596954
6241,34049849,27515579,61565428,1,0,1,5632,5,7605514530
6242,34050670,27548015,61598685,9,0,1,15872,4,894942175
6243,34052069,27546647,61598716,1,0,1,6144,5,10216366929
6244,34053059,27545680,61598739,1,0,1,3584,5,3514579652
6245,34055710,27571155,61626865,2,0,1,6656,19,10651447421
6246,34057580,27569487,61627067,2,0,1,4096,19,6232944555
6247,34059120,19682371,53741491,6,0,0,49152,17,785522506
6248,34062140,27564950,61627090,2,0,1,3584,19,1812971669
6249,34063070,20103237,54166307,5,0,0,138240,25,3342701107
6250,34065259,27561854,61627113,3,0,1,9728,21,150389516
6251,34076070,20020246,54096316,6,0,0,103424,17,9337414932
6252,34079830,20025391,54105221,6,0,0,14336,17,3150507483
6253,34081140,19759211,53840351,8,0,0,512,1,8778543378
6254,34089901,27537726,61627627,7,0,1,8192,21,6016973948
6255,34094340,19674052,53768392,8,0,0,1536,1,10326999628
6256,34101240,19714658,53815898,1,0,0,11264,5,10651245736
6257,34104749,27523236,61627985,1,0,1,2048,5,588927389
6258,34105831,27522177,61628008,7,0,1,6144,21,7492724396
6259,34111679,27516352,61628031,1,0,1,1024,5,2393375616
6260,34124950,19816160,53941110,5,0,0,25600,25,5600977348
6261,34126090,27558195,61684285,9,0,1,38912,4,7377831521
6262,34131450,19921393,54052843,1,0,0,73728,5,8127938382
6263,34134270,20095829,54230099,6,0,0,2560,17,7962082449
6264,34146050,27562011,61708061,2,0,1,6144,19,2982583439
6265,34150259,27560068,61710327,1,0,1,3584,5,7769821935
6266,34151080,20149497,54300577,8,0,0,512,1,7663768237
6267,34155240,19902664,54057904,1,0,0,16384,5,1015720182
6268,34157860,27559034,61716894,9,0,1,31232,4,6463963959
6269,34161849,27571255,61733104,1,0,1,6656,5,10568691644
6270,34163910,19900201,54064111,6,0,0,19968,17,1260600464
6271,34166959,27568091,61735050,1,0,1,3072,5,8169824503
6272,34168760,19788480,53957240,6,0,0,11264,17,250738335
6273,34173370,19856986,54030356,6,0,0,45056,17,7923119379
6274,34174741,27567286,61742027,5,0,1,33280,25,3437722621
6275,34180800,27695760,61876560,9,0,1,114176,4,10419109002
6276,34183119,27696086,61879205,1,0,1,2048,5,3412522279
6277,34200870,27680186,61881056,4,0,1,512,25,230561276
6278,34202710,19862048,54064758,6,0,0,2048,17,488700165
6279,34205880,27676162,61882042,2,0,1,1536,19,5057673165
6280,34213840,27682797,61896637,2,0,1,9728,19,9883024125
6281,34218191,27678600,61896791,7,0,1,8704,21,6412131497
6282,34222311,27678986,61901297,5,0,1,7168,25,10641295764
6283,34227130,27674833,61901963,2,0,1,1024,19,5657815030
6284,34227751,27677118,61904869,5,0,1,4608,25,9378550747
6285,34238140,27668675,61906815,2,0,1,3072,19,5001686153
6286,34239479,27698392,61937871,1,0,1,1536,5,6114323466
6287,34239610,19870146,54109756,8,0,0,1536,1,10162793157
6288,34242570,20063536,54306106,8,0,0,1536,1,6291763343
6289,34243470,27697595,61941065,2,0,1,2560,19,803795572
6290,34244781,27696438,61941219,7,0,1,8704,21,2870554682
6291,34246640,27696205,61942845,2,0,1,2560,19,3372197630
6292,34247069,27698362,61945431,1,0,1,4096,5,625630036
6293,34253480,27693720,61947200,2,0,1,1536,19,1901336793
6294,34256789,27693957,61950746,1,0,1,5632,5,7158420294
6295,34258920,20041478,54300398,1,0,0,164864,5,1828279745
6296,34260310,20040602,54300912,8,0,0,1024,1,1075331203
6297,34262710,20066065,54328775,8,0,0,1536,1,6176642171
6298,34266049,27686003,61952052,1,0,1,2048,5,2905002113
6299,34279810,20029056,54308866,1,0,0,8704,5,1408545200
6300,34280041,27684322,61964363,5,0,1,18944,25,2388890705
6301,34290999,27678942,61969941,1,0,1,11776,5,3522744003
6302,34301491,27688331,61989822,5,0,1,30720,25,7982948942
6303,34307610,27694891,62002501,2,0,1,1536,19,1822846055
6304,34317130,20094326,54411456,1,0,0,22016,5,3665471737
6305,34325481,27678326,62003807,7,0,1,2048,21,458800389
6306,34330420,19975195,54305615,1,0,0,15360,5,8770684982
6307,34332470,20013564,54346034,5,0,0,32256,25,6562742783
6308,34335470,27668683,62004153,2,0,1,512,19,7968728460
6309,34339220,27665919,62005139,2,0,1,1536,19,9196357582
6310,34348371,27658970,62007341,5,0,1,12288,25,1919668462
6311,34367640,27642287,62009927,2,0,1,4096,19,4194177122
6312,34369919,27640354,62010273,1,0,1,512,5,9022936742
6313,34378521,27632418,62010939,7,0,1,1024,21,2244275327
6314,34378871,27638277,62017148,5,0,1,22528,25,8715993663
6315,34380550,20227889,54608439,1,0,0,102400,5,1870901222
6316,34385390,27637123,62022513,2,0,1,512,19,8955809145
6317,34391221,27644779,62036000,5,0,1,16896,25,5161600165
6318,34397980,20034764,54432744,1,0,0,20992,5,1467572559
6319,34399860,27656265,62056125,2,0,1,5632,19,1909788623
6320,34400749,27655722,62056471,1,0,1,512,5,23824882
6321,34403820,27654917,62058737,2,0,1,3584,19,8556828042
6322,34403991,27659572,62063563,7,0,1,7680,21,10285853035
6323,34407009,27662845,62069854,8,0,1,1024,1,9208596845
6324,34407060,27662948,62070008,2,0,1,8704,19,4825757437
6325,34407650,20084395,54492045,5,0,0,43008,25,4948210844
6326,34419161,27651193,62070354,7,0,1,512,21,9517889297
6327,34423639,27647176,62070815,8,0,1,10240,1,2983221246
6328,34427570,27654742,62082312,2,0,1,4608,19,4188571107
6329,34429739,27654865,62084604,8,0,1,3584,1,4889381723
6330,34434820,27652690,62087510,2,0,1,4608,19,637949395
6331,34435759,27674717,62110476,8,0,1,512,1,8192582379
6332,34440250,20180962,54621212,8,0,0,512,1,6883289177
6333,34441261,27669561,62110822,7,0,1,512,21,950871019
6334,34443470,27786123,62229593,0,0,1,114176,8,3027608883
6335,34443709,27811925,62255634,8,0,1,2560,1,7147470517
6336,34445030,20236239,54681269,1,0,0,116736,5,9081333752
6337,34449800,19984839,54434639,5,0,0,6144,25,8761230617
6338,34450760,20237153,54687913,6,0,0,21504,17,6120371166
6339,34458210,20119006,54577216,6,0,0,5632,17,2699832127
6340,34459641,27796557,62256198,7,0,1,10752,21,4789290171
6341,34459680,20069801,54529481,5,0,0,44032,25,8599248345
6342,34474361,27796372,62270733,7,0,1,2560,21,5122560653
6343,34476810,27793946,62270756,2,0,1,1536,19,1362593018
6344,34477960,27792819,62270779,2,0,1,2560,19,1788826734
6345,34491570,27779232,62270802,2,0,1,1024,19,4733464840
6346,34502239,27807660,62309899,8,0,1,11776,1,10180812824
6347,34503650,27822805,62326455,2,0,1,18432,19,1725585289
6348,34506191,27855262,62361453,7,0,1,12288,21,2756544205
6349,34521781,27840186,62361967,7,0,1,32256,21,9860263160
6350,34524101,27884618,62408719,7,0,1,512,21,9069693455
6351,34529851,27895464,62425315,7,0,1,10240,21,10177497640
6352,34533949,27895232,62429181,1,0,1,6144,5,6509550900
6353,34536060,27898267,62434327,2,0,1,8192,19,6698891396
6354,34542081,27893872,62435953,7,0,1,2560,21,551619747
6355,34547630,20268930,54816560,1,0,0,76288,5,795341922
6356,34557759,27902842,62460601,1,0,1,16896,5,5117317348
6357,34558799,27902160,62460959,1,0,1,7168,5,8371684779
6358,34560779,27900203,62460982,8,0,1,2560,1,5900151563
6359,34584090,20234365,54818455,5,0,0,6144,25,8403409141
6360,34585139,27875866,62461005,8,0,1,3072,1,5257554882
6361,34585419,27875609,62461028,8,0,1,13824,1,6061907258
6362,34592479,27887653,62480132,8,0,1,5120,1,9861761751
6363,34610610,20140697,54751307,1,0,0,5120,5,467446928
6364,34610711,27869597,62480308,7,0,1,8704,21,3235847533
6365,34618829,27864554,62483383,8,0,1,2560,1,9413901568
6366,34620250,27875573,62495823,2,0,1,2048,19,3602490506
6367,34622300,20320854,54943154,1,0,0,68608,5,3747760771
6368,34639370,20386196,55025566,6,0,0,112128,17,7059770080
6369,34640490,20319129,54959619,6,0,0,2560,17,9695097456
6370,34650451,27846998,62497449,7,0,1,2560,21,8436945840
6371,34653239,27845516,62498755,1,0,1,2048,5,567729547
6372,34655311,27858167,62513478,7,0,1,1536,21,8588787872
6373,34663411,27850090,62513501,7,0,1,1024,21,2377321235
6374,34663470,27850054,62513524,2,0,1,9728,19,7813609705
6375,34679200,20281331,54960531,8,0,0,512,1,7639764322
6376,34684931,27843171,62528102,7,0,1,3584,21,7909721992
6377,34690639,27837486,62528125,1,0,1,1536,5,915424699
6378,34695700,27832448,62528148,2,0,1,1024,19,3061317146
6379,34702309,27831096,62533405,1,0,1,19968,5,2951019456
6380,34702859,27832172,62535031,1,0,1,2560,5,10354378824
6381,34704320,27915806,62620126,9,0,1,56832,4,2553178805
6382,34707670,20261444,54969114,8,0,0,512,1,1414350386
6383,34730240,28086304,62816544,9,0,1,154112,4,8047344980
6384,34731430,20211995,54943425,8,0,0,512,1,7288308971
6385,34744280,28088253,62832533,9,0,1,17408,4,8613460720
6386,34744420,28088315,62832735,2,0,1,5120,19,5812716692
6387,34745801,28086957,62832758,7,0,1,512,21,8987553844
6388,34749490,28083782,62833272,2,0,1,2048,19,351145117
6389,34761380,20358034,55119414,1,0,0,52736,5,3324810064
6390,34761461,28072925,62834386,7,0,1,15872,21,2616879411
6391,34764310,20339013,55103323,1,0,0,21504,5,6255783480
6392,34765380,20413651,55179031,5,0,0,30208,25,5312632296
6393,34769670,28105003,62874673,9,0,1,34304,4,4874751982
6394,34772350,20517165,55289515,1,0,0,24064,5,1759458579
6395,34779720,20480927,55260647,5,0,0,65536,25,8647526373
6396,34779760,28203670,62983430,9,0,1,94208,4,8691605651
6397,34793971,28192045,62986016,5,0,1,4096,25,4051437400
6398,34795820,28345841,63141661,9,0,1,201728,4,8129474450
6399,34795920,28373606,63169526,0,0,1,3072,8,9738730455
6400,34800340,28369209,63169549,2,0,1,1024,19,2748825714
6401,34801821,28368086,63169907,7,0,1,13824,21,5685734284
6402,34803170,28366760,63169930,2,0,1,512,19,8792942931
6403,34817499,28352454,63169953,1,0,1,5632,5,10232607567
6404,34822161,28347815,63169976,7,0,1,3072,21,8551166438
6405,34832010,28350406,63182416,9,0,1,34304,4,4303372984
6406,34840350,28376172,63216522,9,0,1,35328,4,9484379500
6407,34844000,28382840,63226840,2,0,1,512,19,5786064711
6408,34847001,28381145,63228146,7,0,1,2048,21,4096204381
6409,34863619,28383804,63247423,1,0,1,4608,5,6110333469
6410,34870570,28449200,63319770,0,0,1,88064,8,4817270209
6411,34875061,28445375,63320436,7,0,1,11264,21,10658806147
6412,34879920,28486073,63365993,2,0,1,3584,19,6324705465
6413,34882250,20763157,55645407,6,0,0,43520,17,10218023399
6414,34883230,20910134,55793364,6,0,0,99840,17,6536344264
6415,34883370,28494785,63378155,9,0,1,49664,4,10438761878
6416,34885760,28715554,63601314,0,0,1,273408,8,10548280742
6417,34891500,28722947,63614447,9,0,1,37376,4,7558081937
6418,34924489,28740576,63665065,1,0,1,24064,5,727869295
6419,34926430,20971662,55898092,5,0,0,67584,25,8022485062
6420,34927040,20703813,55630853,1,0,0,46080,5,3200512071
6421,34936870,28747897,63684767,9,0,1,8704,4,5903729234
6422,34950810,28733980,63684790,9,0,1,5632,4,6628770658
6423,34952879,28740709,63693588,1,0,1,2048,5,2050698011
6424,34956770,20774295,55731065,6,0,0,26624,17,8845976753
6425,34959880,20672244,55632124,5,0,0,4096,25,6738061133
6426,34960199,28733412,63693611,1,0,1,6144,5,3718041288
6427,34961450,28732693,63694143,2,0,1,2560,19,1692830854
6428,34963240,28734795,63698035,9,0,1,6144,4,3159144669
6429,34965410,28748705,63714115,9,0,1,51712,4,6501336104
6430,34972260,28756695,63728955,2,0,1,6656,19,2250354138
6431,34972570,20790328,55762898,5,0,0,39936,25,2475057640
6432,34973060,28927935,63900995,9,0,1,210944,4,3069788465
6433,34973170,28939462,63912632,0,0,1,26624,8,5058831823
6434,34975320,28954675,63929995,9,0,1,27136,4,6805934717
6435,34977480,20921461,55898941,5,0,0,2560,25,6329704623
6436,34980740,28956112,63936852,9,0,1,1536,4,9736226732
6437,34984759,28952758,63937517,1,0,1,1024,5,42315830
6438,34989180,28948683,63937863,4,0,1,512,25,9302161435
6439,34990710,28951339,63942049,4,0,1,6656,25,1069327149
6440,34991910,28952085,63943995,0,0,1,3072,8,8049493056
6441,34993270,20871651,55864921,6,0,0,114688,17,2326116099
6442,34994680,21062650,56057330,6,0,0,31232,17,3283699824
6443,35023090,21158619,56181709,5,0,0,18432,25,8482777988
6444,35023630,28934574,63958204,9,0,1,21504,4,4186749279
6445,35024649,28933901,63958550,1,0,1,512,5,2834149201
6446,35029590,28934349,63963939,9,0,1,17408,4,5424672210
6447,35033710,20881014,55914724,5,0,0,11264,25,1708788073
6448,35042250,28924941,63967191,2,0,1,5120,19,2329113724
6449,35042910,28924947,63967857,2,0,1,1024,19,4347141301
6450,35050690,28920073,63970763,4,0,1,4608,25,1591189551
6451,35051500,21230687,56282187,5,0,0,43008,25,259569493
6452,35058850,28916445,63975295,4,0,1,17408,25,9871372976
6453,35065530,21121632,56187162,6,0,0,8704,17,1450202520
6454,35068829,28914941,63983770,1,0,1,7680,5,8552625063
6455,35069700,21047829,56117529,5,0,0,31232,25,4979141409
6456,35069809,28916227,63986036,1,0,1,3584,5,7182402439
6457,35071570,21150164,56221734,1,0,0,46080,5,221591981
6458,35080479,28909103,63989582,1,0,1,5632,5,5287286254
6459,35081059,28918944,64000003,1,0,1,15872,5,3003211331
6460,35083230,20873596,55956826,5,0,0,7168,25,8509785184
6461,35089840,28913493,64003333,4,0,1,512,25,4924533601
6462,35097670,29001813,64099483,0,0,1,140288,8,4705284817
6463,35105220,20969761,56074981,6,0,0,57856,17,1332267161
6464,35111880,20839579,55951459,5,0,0,7168,25,3597297082
6465,35112250,28988859,64101109,2,0,1,2560,19,4572478940
6466,35113910,28988185,64102095,2,0,1,1536,19,524240178
6467,35151040,28951721,64102761,2,0,1,1024,19,2765794632
6468,35156769,28965639,64122408,3,0,1,23040,21,7291222424
6469,35171260,21134157,56305417,1,0,0,20480,5,3586658897
6470,35175260,28952703,64127963,4,0,1,12800,25,10032634312
6471,35181460,28946849,64128309,4,0,1,512,25,6452255061
6472,35182470,28947145,64129615,4,0,1,2048,25,4334996732
6473,35184489,28947110,64131599,3,0,1,2048,21,4403177415
6474,35186750,28944872,64131622,2,0,1,512,19,2444203897
6475,35190700,28946315,64137015,0,0,1,27136,8,1624924126
6476,35196160,28957764,64153924,0,0,1,7168,8,9870788716
6477,35196280,28997590,64193870,0,0,1,33792,8,6763519008
6478,35197869,29001147,64199016,1,0,1,8192,5,3423239781
6479,35199710,29003812,64203522,2,0,1,7168,19,8807930352
6480,35202540,29004528,64207068,2,0,1,5632,19,3592972779
6481,35207100,29002234,64209334,4,0,1,3584,25,6813328446
6482,35211750,21194770,56406520,6,0,0,73216,17,4171614134
6483,35220701,28994842,64215543,7,0,1,21504,21,4720993044
6484,35226370,28989839,64216209,4,0,1,11264,25,2177586110
6485,35232989,28985806,64218795,1,0,1,4096,5,8095956397
6486,35235220,28984241,64219461,4,0,1,11264,25,6872603780
6487,35243970,28994003,64237973,4,0,1,9728,25,5770145947
6488,35246579,28991740,64238319,3,0,1,512,21,7104944721
6489,35250850,29047842,64298692,0,0,1,71168,8,570351857
6490,35262010,29057171,64319181,2,0,1,2048,19,5661043492
6491,35276170,29043369,64319539,4,0,1,512,25,7094005060
6492,35282650,29036912,64319562,2,0,1,16384,19,4084813727
6493,35284969,29034933,64319902,3,0,1,3584,21,591808972
6494,35285960,21175787,56461747,6,0,0,48640,17,257334770
6495,35285979,29034282,64320261,1,0,1,9728,5,10652406373
6496,35286030,21098059,56384089,1,0,0,73216,5,7494731674
6497,35287129,29037638,64324767,3,0,1,7168,21,9262634279
6498,35292370,21039240,56331610,5,0,0,16384,25,3274372266
6499,35295540,29030780,64326320,2,0,1,1536,19,1537113213
6500,35301420,29026526,64327946,4,0,1,2560,25,1844930293
6501,35304460,29025432,64329892,4,0,1,3072,25,10260046311
6502,35304991,29028767,64333758,7,0,1,6144,21,6924746950
6503,35312220,29044353,64356573,0,0,1,4608,8,6227498763
6504,35318280,29039279,64357559,4,0,1,1536,25,4464004975
6505,35319630,29047519,64367149,2,0,1,512,19,7337888482
6506,35324690,20881885,56206575,1,0,0,1536,5,7312435106
6507,35324739,29045636,64370375,1,0,1,5120,5,4890570408
6508,35332690,21341977,56674667,8,0,0,512,1,1107567354
6509,35335769,29039112,64374881,1,0,1,7168,5,1135025038
6510,35337389,29038798,64376187,1,0,1,2048,5,1036166019
6511,35337500,21024212,56361712,1,0,0,50688,5,2755345279
6512,35344209,29032964,64377173,1,0,1,1536,5,6629127236
6513,35354381,29025378,64379759,7,0,1,4096,21,7351110613
6514,35359150,21084241,56443391,1,0,0,24064,5,10000274374
6515,35362599,29044981,64407580,3,0,1,13312,21,2888670216
6516,35363599,29044237,64407836,1,0,1,9216,5,2084221854
6517,35365890,29122842,64488732,0,0,1,73216,8,6003036625
6518,35378219,29110859,64489078,3,0,1,512,21,4357519332
6519,35378450,21204647,56583097,1,0,0,34304,5,5634783986
6520,35378499,29111245,64489744,1,0,1,1024,5,143276768
6521,35382380,29109310,64491690,4,0,1,3072,25,6961219075
6522,35391909,29109664,64501573,1,0,1,25600,5,9280231191
6523,35394559,29108960,64503519,3,0,1,3072,21,3003606833
6524,35398050,21015723,56413773,7,0,0,23552,21,8664590904
6525,35398249,29109136,64507385,3,0,1,6144,21,10290648286
6526,35400930,21027943,56428873,5,0,0,28672,25,8747025776
6527,35404530,29106721,64511251,4,0,1,6144,25,7720615859
6528,35408460,29103137,64511597,4,0,1,512,25,7600246768
6529,35415731,29097172,64512903,7,0,1,2048,21,3087962165
6530,35433449,29090515,64523964,1,0,1,5632,5,2252569520
6531,35440241,29093865,64534106,7,0,1,7168,21,10026780423
6532,35441551,29231363,64672914,7,0,1,19456,21,1569640551
6533,35442211,29232969,64675180,7,0,1,3584,21,6827067661
6534,35446970,21302344,56749314,6,0,0,58880,17,5460743703
6535,35453290,21081615,56534905,1,0,0,23552,5,8180542573
6536,35455550,29232797,64688347,4,0,1,15872,25,7777984735
6537,35459360,21006021,56465381,5,0,0,11776,25,865703596
6538,35461180,29227833,64689013,2,0,1,1024,19,8478959060
6539,35472730,29376757,64849487,0,0,1,97792,8,6718169606
6540,35486250,21486623,56972873,7,0,0,4608,21,8775055156
6541,35487510,21294353,56781863,1,0,0,47616,5,3018986460
6542,35494261,29364583,64858844,7,0,1,9216,21,4219191114
6543,35498280,21190965,56689245,5,0,0,13824,25,3799846418
6544,35516260,21663638,57179898,5,0,0,18944,25,260333925
6545,35521590,29339332,64860922,4,0,1,3072,25,5322292690
6546,35534751,29342580,64877331,7,0,1,6656,21,8787161958
6547,35540970,21176930,56717900,6,0,0,50176,17,6183257667
6548,35545131,29332223,64877354,7,0,1,512,21,5495452327
6549,35546240,21244328,56790568,7,0,0,16384,21,9093727530
6550,35552150,29438673,64990823,9,0,1,45056,4,4573937071
6551,35553020,29437826,64990846,4,0,1,10240,25,5831825111
6552,35553230,21391029,56944259,7,0,0,182784,21,4222327169
6553,35554430,21497782,57052212,5,0,0,101376,25,410509920
6554,35559159,29431889,64991048,1,0,1,512,5,5330839963
6555,35561290,21195464,56756754,7,0,0,7680,21,2687536650
6556,35563459,29427612,64991071,3,0,1,4608,21,1913008227
6557,35569420,29421674,64991094,9,0,1,16896,4,3781769696
6558,35570790,29449389,65020179,9,0,1,8192,4,10090040516
6559,35572400,29447802,65020202,9,0,1,11264,4,4370673964
6560,35572440,21509112,57081552,1,0,0,20992,5,655571620
6561,35576360,29443881,65020241,4,0,1,7680,25,7489636707
6562,35582810,29443405,65026215,4,0,1,7168,25,3153061645
6563,35600120,21512133,57112253,5,0,0,41984,25,2599881479
6564,35604150,21495288,57099438,1,0,0,18944,5,4003981973
6565,35611070,29416782,65027852,4,0,1,8704,25,10647054332
6566,35621810,21608326,57230136,5,0,0,95232,25,894781664
6567,35628960,21545143,57174103,5,0,0,100864,25,777301994
6568,35629580,29398295,65027875,4,0,1,512,25,8220169204
6569,35630040,21747854,57377894,7,0,0,107008,21,4629534116
6570,35638360,21315126,56953486,7,0,0,30208,21,10534917999
6571,35638740,29390402,65029142,4,0,1,6144,25,4539452924
6572,35644100,29409518,65053618,2,0,1,1024,19,10660471235
6573,35648929,29440985,65089914,8,0,1,5632,1,10478996944
6574,35654740,21598062,57252802,5,0,0,10240,25,3356076272
6575,35659160,29432060,65091220,4,0,1,2048,25,7125370018
6576,35659199,29432687,65091886,3,0,1,1024,21,7875768097
6577,35664230,29427912,65092142,2,0,1,9216,19,8764695658
6578,35664551,29430103,65094654,7,0,1,10240,21,2790332276
6579,35674000,29421000,65095000,2,0,1,512,19,4172704573
6580,35681150,21837730,57518880,5,0,0,145408,25,1728259950
6581,35684660,21508365,57193025,1,0,0,43008,5,9725737628
6582,35690509,29405797,65096306,8,0,1,2048,1,6822519644
6583,35694969,29402323,65097292,8,0,1,1536,1,8277516900
6584,35705120,21577861,57282981,1,0,0,5632,5,10462631511
6585,35720450,21403384,57123834,1,0,0,13312,5,10006633130
6586,35728240,21521419,57249659,7,0,0,64000,21,2385905727
6587,35731740,29365706,65097446,4,0,1,8704,25,6719423421
6588,35737910,21532739,57270649,5,0,0,7168,25,8186999952
6589,35744390,21249746,56994136,6,0,0,5632,17,9043327756
6590,35747570,21683619,57431189,6,0,0,58880,17,7782533159
6591,35748770,21712804,57461574,6,0,0,30208,17,8530362778
6592,35750861,29371046,65121907,7,0,1,10752,21,9818523311
6593,35753759,29385028,65138787,8,0,1,4608,1,5273278860
6594,35759499,29379634,65139133,8,0,1,512,1,7490203440
6595,35759900,29383739,65143639,9,0,1,7168,4,3283292897
6596,35767090,21346442,57113532,7,0,0,4096,21,5685940175
6597,35770400,29382956,65153356,2,0,1,23552,19,1364352668
6598,35771939,29387434,65159373,8,0,1,20480,1,1039888104
6599,35785990,21492972,57278962,7,0,0,512,21,1271524986
6600,35787810,29394249,65182059,4,0,1,3072,25,26408354
6601,35790100,21623103,57413203,6,0,0,100864,17,9173644774
6602,35798050,29385635,65183685,9,0,1,2560,4,822692157
6603,35801360,29383951,65185311,4,0,1,2560,25,8893925592
6604,35802039,29383938,65185977,8,0,1,1024,1,9161274613
6605,35803660,21670885,57474545,6,0,0,42496,17,1733270963
6606,35811170,21569087,57380257,5,0,0,7680,25,4905245020
6607,35846040,29398253,65244293,2,0,1,1024,19,7998290480
6608,35848060,22104592,57952652,1,0,0,36352,5,7648499850
6609,35848320,21675933,57524253,6,0,0,17408,17,2788748761
6610,35854560,29389756,65244316,9,0,1,3072,4,835660967
6611,35867770,29376569,65244339,4,0,1,22528,25,1708315946
6612,35869660,21657851,57527511,5,0,0,10240,25,1827748040
6613,35883230,29484763,65367993,9,0,1,2048,4,7550423895
6614,35887900,21545120,57433020,5,0,0,5632,25,256884056
6615,35893260,29474756,65368016,4,0,1,3072,25,1776621106
6616,35894470,21539103,57433573,1,0,0,1536,5,5708054086
6617,35896290,29471749,65368039,2,0,1,1536,19,7313638651
6618,35905770,29476243,65382013,9,0,1,11776,4,6960805195
6619,35906690,29477589,65384279,4,0,1,3584,25,8095105739
6620,35907800,29477145,65384945,9,0,1,1024,4,8519209813
6621,35915440,21849125,57764565,6,0,0,28672,17,5781808574
6622,35923630,29479892,65403522,4,0,1,5632,25,9635560758
6623,35928889,29487535,65416424,8,0,1,7168,1,4323490574
6624,35930080,21676671,57606751,1,0,0,1024,5,1575866755
6625,35942060,22216290,58158350,7,0,0,66048,21,8966134863
6626,35943680,29476708,65420388,3,0,1,6144,21,1658195538
6627,35946340,21616365,57562705,1,0,0,6656,5,5547804324
6628,35949250,29473946,65423196,4,0,1,4608,25,9071113660
6629,35951750,29471792,65423542,9,0,1,512,4,5618632223
6630,35957110,29469338,65426448,4,0,1,4608,25,1657121136
6631,35966710,22243725,58210435,6,0,0,47616,17,7005906477
6632,35967270,29459844,65427114,2,0,1,1024,19,8684187001
6633,35979130,29448138,65427268,2,0,1,8704,19,5579820086
6634,35980320,21685813,57666133,5,0,0,13312,25,6912491641
6635,35983280,29494680,65477960,4,0,1,1024,25,1689419497
6636,35987770,29490213,65477983,2,0,1,2048,19,7458417821
6637,35988420,29590167,65578587,4,0,1,9216,25,9631801574
6638,36000170,22409928,58410098,6,0,0,117760,17,566370642
6639,36000560,29601941,65602501,2,0,1,512,19,7180810092
6640,36000680,22073898,58074578,6,0,0,22016,17,6929776856
6641,36006340,22628161,58634501,7,0,0,186880,21,1760852623
6642,36006760,29597047,65603807,4,0,1,2048,25,1695848603
6643,36011650,22121001,58132651,1,0,0,81920,5,8896024456
6644,36013280,29621518,65634798,4,0,1,12800,25,2968280651
6645,36021490,22394715,58416205,1,0,0,19968,5,1810316132
6646,36034980,29603684,65638664,9,0,1,6144,4,9266244611
6647,36037790,21823613,57861403,6,0,0,512,17,3170935690
6648,36039810,22049600,58089410,1,0,0,13312,5,6591092317
6649,36042630,22670767,58713397,5,0,0,52224,25,925111746
6650,36046190,29685466,65731656,2,0,1,3584,19,6297259719
6651,36046240,29777092,65823332,2,0,1,2048,19,8018120122
6652,36047790,22169087,58216877,1,0,0,20992,5,5117710107
6653,36069850,29760708,65830558,9,0,1,7680,4,2920252881
6654,36070690,29823060,65893750,2,0,1,4608,19,1990498300
6655,36074570,22568135,58642705,6,0,0,26624,17,6651771120
6656,36075930,22403710,58479640,6,0,0,38400,17,3475022081
6657,36086490,22138210,58224700,6,0,0,25600,17,8552316316
6658,36092180,29801593,65893773,3,0,1,1024,21,10089053091
6659,36100619,29793356,65893975,3,0,1,7168,21,6975682000
6660,36118029,29798931,65916960,3,0,1,7168,21,8054027152
6661,36123109,29803827,65926936,3,0,1,8192,21,10274779509
6662,36134550,22036171,58170721,6,0,0,40448,17,3287801237
6663,36139130,22147436,58286566,7,0,0,18944,21,9582346537
6664,36139700,22278712,58418412,5,0,0,7168,25,9102385107
6665,36159800,29769402,65929202,2,0,1,3584,19,5997527726
6666,36172990,29791550,65964540,2,0,1,16896,19,2910425141
6667,36176150,22338637,58514787,6,0,0,115200,17,10524471757
6668,36182570,29781993,65964563,3,0,1,512,21,1304097469
6669,36183760,22472103,58655863,5,0,0,39424,25,5985967426
6670,36184500,22154606,58339106,7,0,0,46080,21,8315130040
6671,36192000,29772586,65964586,2,0,1,11776,19,2548510560
6672,36196350,21706366,57902716,7,0,0,21504,21,1370173456
6673,36205930,21932273,58138203,1,0,0,17920,5,1446148587
6674,36207690,29775356,65983046,3,0,1,4096,21,10029185203
6675,36209980,22367550,58577530,6,0,0,205824,17,8029814552
6676,36220690,22452824,58673514,5,0,0,57856,25,7600882675
6677,36222010,29805391,66027401,4,0,1,4608,25,29031487
6678,36236540,22981422,59217962,7,0,0,82432,21,5856976779
6679,36238500,22604574,58843074,7,0,0,27136,21,9109495326
6680,36243860,22448084,58691944,6,0,0,2048,17,9024494598
6681,36249000,22435652,58684652,5,0,0,36352,25,8906755779
6682,36258560,29785307,66043867,2,0,1,3072,19,10625835553
6683,36261400,29782490,66043890,3,0,1,512,21,1799728515
6684,36262290,29791780,66054070,4,0,1,1536,25,5376765263
6685,36266790,29791786,66058576,2,0,1,7168,19,9020689286
6686,36272090,22042603,58314693,7,0,0,2560,21,4875011052
6687,36275260,22842352,59117612,7,0,0,21504,21,1441648150
6688,36282840,29780569,66063409,2,0,1,3584,19,7015212091
6689,36282860,29786814,66069674,3,0,1,3584,21,430459557
6690,36285880,29784140,66070020,9,0,1,512,4,3203003356
6691,36289390,29782576,66071966,2,0,1,3072,19,6123693748
6692,36289690,29784222,66073912,0,0,1,3072,8,3809571107
6693,36298100,29788057,66086157,0,0,1,23040,8,7104473375
6694,36298260,22657814,58956074,6,0,0,78848,17,7830225637
6695,36302630,22629397,58932027,5,0,0,35840,25,5033995249
6696,36305050,29783373,66088423,4,0,1,3584,25,3898658499
6697,36309290,29874130,66183420,2,0,1,4608,19,4090897313
6698,36310760,22157088,58467848,5,0,0,44032,25,9259273335
6699,36314410,21770517,58084927,6,0,0,26112,17,9593520741
6700,36314500,22998971,59313471,1,0,0,19456,5,9839861703
6701,36317180,29874117,66191297,2,0,1,10752,19,6343914665
6702,36321520,29870805,66192325,3,0,1,1024,21,3131935436
6703,36330770,22503944,58834714,5,0,0,45056,25,2591365055
6704,36333250,29943662,66276912,0,0,1,30720,8,6073913056
6705,36369670,29909828,66279498,9,0,1,4096,4,9969240700
6706,36375990,30042216,66418206,2,0,1,8704,19,9268343183
6707,36376860,30041369,66418229,3,0,1,6656,21,10288259332
6708,36384440,21919884,58304324,1,0,0,11776,5,483509602
6709,36388520,30101567,66490087,4,0,1,8192,25,9423896650
6710,36405250,23155204,59560454,5,0,0,19968,25,10036710179
6711,36410060,30080373,66490433,2,0,1,512,19,1360977962
6712,36413760,30078299,66492059,9,0,1,2560,4,7717985958
6713,36416820,30078145,66494965,4,0,1,4608,25,2104451980
6714,36423450,30073781,66497231,9,0,1,3584,4,3561932300
6715,36424260,30073637,66497897,2,0,1,1024,19,1543321047
6716,36427220,21929505,58356725,5,0,0,9216,25,878635835
6717,36430560,22570942,59001502,7,0,0,39936,21,510740445
6718,36431320,22255235,58686555,5,0,0,6144,25,3248288413
6719,36433980,30105811,66539791,4,0,1,9728,25,6720476176
6720,36439340,30302795,66742135,0,0,1,67584,8,3197941054
6721,36442350,22253369,58695719,7,0,0,12288,21,6407525421
6722,36452590,30289568,66742158,3,0,1,2560,21,1290228020
6723,36454550,22849671,59304221,7,0,0,66048,21,7290931909
6724,36456320,22736480,59192800,7,0,0,112128,21,1905739915
6725,36458810,22309563,58768373,6,0,0,58880,17,6268353607
6726,36461700,22459384,58921084,1,0,0,14848,5,6114123216
6727,36462690,30284194,66746884,3,0,1,5632,21,9964528340
6728,36463000,22335850,58798850,7,0,0,22528,21,1585322249
6729,36468930,22174890,58643820,7,0,0,3584,21,1365713764
6730,36502840,22552746,59055586,5,0,0,61952,25,3614048217
6731,36507870,23033337,59541207,6,0,0,134656,17,2222080122
6732,36515690,30287859,66803549,0,0,1,48128,8,8519609839
6733,36517560,21907271,58424831,5,0,0,20992,25,242010702
6734,36518520,30349851,66868371,0,0,1,37376,8,5431031530
6735,36528980,30348906,66877886,4,0,1,2048,25,8452860796
6736,36538600,30344112,66882712,3,0,1,7680,21,7748920538
6737,36548930,30334768,66883698,3,0,1,1536,21,7957699331
6738,36558440,30326564,66885004,4,0,1,2048,25,2237768470
6739,36564610,30344092,66908702,4,0,1,3072,25,3336874798
6740,36572570,30354695,66927265,4,0,1,2048,25,3532007191
6741,36577470,30571341,67148811,0,0,1,105984,8,10505938384
6742,36580310,30568524,67148834,2,0,1,15360,19,3075534179
6743,36585410,23109017,59694427,1,0,0,20480,5,3700201210
6744,36603590,30546070,67149660,3,0,1,3072,21,10336975063
6745,36607310,22469359,59076669,7,0,0,69120,21,2816278934
6746,36608050,30541633,67149683,4,0,1,3072,25,4786523508
6747,36614110,22627321,59241431,5,0,0,26112,25,6981281805
6748,36616660,30533046,67149706,3,0,1,9216,21,3501677625
6749,36620760,22261991,58882751,7,0,0,39936,21,6031385712
6750,36634900,30519696,67154596,4,0,1,6144,25,4927899661
6751,36637520,30517099,67154619,2,0,1,1024,19,6996443313
6752,36640220,30514422,67154642,3,0,1,512,21,2430556781
6753,36649300,22041958,58691258,6,0,0,15360,17,3996134661
6754,36650980,30533129,67184109,4,0,1,8704,25,2197225976
6755,36654670,30529462,67184132,4,0,1,3584,25,8969198879
6756,36654999,30529156,67184155,1,0,1,5632,5,8829354546
6757,36659040,22358085,59017125,5,0,0,51200,25,4217890711
6758,36663910,30693204,67357114,0,0,1,75264,8,1719267963
6759,36668200,30691918,67360118,3,0,1,10240,21,5360623620
6760,36668630,30728371,67397001,2,0,1,16384,19,6005657292
6761,36672279,30742351,67414630,1,0,1,6144,5,6367579558
6762,36674160,22590882,59265042,6,0,0,77312,17,2511297307
6763,36676520,22556441,59232961,6,0,0,49152,17,6705026937
6764,36684510,30748250,67432760,4,0,1,13824,25,615705736
6765,36690640,22809516,59500156,5,0,0,512,25,7826658074
6766,36700350,30733076,67433426,4,0,1,1024,25,1085459748
6767,36706710,22600810,59307520,5,0,0,10752,25,2478070709
6768,36707550,30726542,67434092,4,0,1,1024,25,8995884192
6769,36708901,30727457,67436358,7,0,1,3584,21,5706597337
6770,36715681,30721343,67437024,5,0,1,11264,25,9172308673
6771,36717290,30720080,67437370,2,0,1,512,19,7479380576
6772,36718300,30719224,67437524,3,0,1,8704,21,5010417635
6773,36718680,22668610,59387290,1,0,0,105472,5,3222610280
6774,36720280,30990075,67710355,0,0,1,120320,8,8784689606
6775,36722450,22550960,59273410,1,0,0,18432,5,7425966563
6776,36730650,30980371,67711021,4,0,1,1024,25,9222011963
6777,36737020,30984147,67721167,3,0,1,17408,21,4229999314
6778,36745399,30980305,67725704,1,0,1,5632,5,9189989914
6779,36756240,30975383,67731623,3,0,1,14848,21,9263754454
6780,36758890,22318114,59077004,6,0,0,1024,17,9743573858
6781,36761050,30974040,67735090,4,0,1,4608,25,2545317485
6782,36762890,22736432,59499322,6,0,0,35328,17,926535108
6783,36764719,30974237,67738956,1,0,1,6144,5,7425457861
6784,36769470,22670815,59440285,1,0,0,78848,5,3991466347
6785,36770990,30972792,67743782,3,0,1,7680,21,7233118056
6786,36771559,31037401,67808960,8,0,1,2560,1,1602871949
6787,36772440,31036543,67808983,4,0,1,512,25,5471895128
6788,36778340,22707832,59486172,7,0,0,150528,21,4067566759
6789,36780100,22362436,59142536,5,0,0,1024,25,5806207186
6790,36785450,31023556,67809006,3,0,1,11264,21,1021484513
6791,36787940,31021089,67809029,0,0,1,3584,8,3085659270
6792,36790740,31018312,67809052,3,0,1,2560,21,4917333906
6793,36792250,22931176,59723426,7,0,0,27648,21,7732511977
6794,36794720,22438732,59233452,6,0,0,1536,17,7343698372
6795,36799590,31009485,67809075,2,0,1,8192,19,8444216965
6796,36802989,31007706,67810695,1,0,1,3072,5,5070699028
6797,36808000,22579469,59387469,5,0,0,512,25,990924559
6798,36809780,22589990,59399770,7,0,0,15360,21,8947167011
6799,36811080,22765995,59577075,7,0,0,15360,21,9854072995
6800,36818360,22681617,59499977,5,0,0,2048,25,3982819374
6801,36820830,22751542,59572372,6,0,0,38912,17,322518173
6802,36838460,22300204,59138664,5,0,0,2048,25,8482334541
6803,36842320,31360060,68202380,0,0,1,177664,8,4926160969
6804,36842330,31385414,68227744,3,0,1,13312,21,8569788329
6805,36846050,22901398,59747448,5,0,0,1024,25,2366439204
6806,36851110,22414111,59265221,6,0,0,512,17,7249116014
6807,36851180,22463406,59314586,6,0,0,3584,17,2152974505
6808,36856320,22937293,59793613,7,0,0,24576,21,2553340351
6809,36859430,31368337,68227767,2,0,1,6144,19,8576796550
6810,36860040,31374660,68234700,4,0,1,1024,25,1947249984
6811,36862809,31371914,68234723,1,0,1,13312,5,1760552352
6812,36863800,22688997,59552797,7,0,0,37888,21,3308088381
6813,36865149,31382436,68247585,1,0,1,4608,5,4824766557
6814,36865539,31382077,68247616,1,0,1,2560,5,7582533830
6815,36866579,31381060,68247639,1,0,1,4608,5,6277740382
6816,36867060,32144260,69011320,0,0,1,254976,8,2089900705
6817,36872910,32138612,69011522,2,0,1,10240,19,10641344168
6818,36874730,22613805,59488535,1,0,0,7680,5,245777038
6819,36877120,32136336,69013456,0,0,1,37376,8,10025864327
6820,36888170,32147346,69035516,2,0,1,25600,19,6429731895
6821,36888880,32150182,69039062,2,0,1,5632,19,1938932188
6822,36896780,22657567,59554347,5,0,0,3072,25,8123630752
6823,36908720,32156904,69065624,4,0,1,7680,25,1536113599
6824,36908980,32187963,69096943,2,0,1,5632,19,8395045948
6825,36914380,22714563,59628943,1,0,0,24576,5,2946193900
6826,36915350,32242692,69158042,0,0,1,25600,8,4273529923
6827,36930760,22793001,59723761,5,0,0,1024,25,311121710
6828,36945020,22705139,59650159,7,0,0,33792,21,3879474350
6829,36948290,32443828,69392118,0,0,1,186368,8,6965096966
6830,36957830,22859592,59817422,6,0,0,11264,17,8547610156
6831,36957910,22595478,59553388,5,0,0,1536,25,4031791987
6832,36959529,32435986,69395515,1,0,1,5632,5,4424252853
6833,36963710,32455266,69418976,0,0,1,37888,8,7034173256
6834,36975790,22735504,59711294,1,0,0,10240,5,9568285924
6835,36980319,32441563,69421882,1,0,1,4608,5,7662906524
6836,36983130,22763983,59747113,7,0,0,33280,21,8787330966
6837,36983940,22948784,59932724,1,0,0,60416,5,7274537823
6838,36984750,22911890,59896640,6,0,0,62976,17,3901793440
6839,37004830,22843649,59848479,7,0,0,22016,21,10298063168
6840,37021919,32463823,69485742,1,0,1,8704,5,972856489
6841,37028289,32457476,69485765,1,0,1,5120,5,5941795388
6842,37041659,32444129,69485788,1,0,1,4608,5,3944646698
6843,37044530,32441281,69485811,4,0,1,4096,25,10542920907
6844,37045250,22731678,59776928,1,0,0,30720,5,5351716141
6845,37056529,32451237,69507766,1,0,1,9216,5,4060533683
6846,37058510,32449279,69507789,2,0,1,2048,19,1047874421
6847,37063260,32444576,69507836,4,0,1,4096,25,798001682
6848,37067269,32440590,69507859,1,0,1,2048,5,4599382611
6849,37067400,22632313,59699713,6,0,0,13824,17,2132426426
6850,37078900,32429161,69508061,4,0,1,4608,25,3788784802
6851,37083920,32424164,69508084,2,0,1,6144,19,10642217685
6852,37086840,32459162,69546002,0,0,1,59392,8,3171923345
6853,37090620,32480833,69571453,4,0,1,3584,25,5624966142
6854,37105900,22881789,59987689,7,0,0,37376,21,4702182387
6855,37106000,22835015,59941015,1,0,0,27136,5,5478344184
6856,37108320,32463156,69571476,4,0,1,6656,25,8038738297
6857,37113360,22999505,60112865,6,0,0,45056,17,4624471374
6858,37124860,22780906,59905766,6,0,0,1536,17,6920184347
6859,37131660,32450248,69581908,0,0,1,53760,8,2664913259
6860,37136120,32458554,69594674,4,0,1,9728,25,2062785967
6861,37142290,22827711,59970001,7,0,0,12800,21,1271699111
6862,37149270,22929804,60079074,7,0,0,92672,21,4957057625
6863,37151800,32449953,69601753,0,0,1,33792,8,4012619482
6864,37159740,22830803,59990543,7,0,0,6656,21,8125586116
6865,37165700,22958139,60123839,5,0,0,1024,25,3979737844
6866,37208320,32411870,69620190,2,0,1,10240,19,6712386904
6867,37210010,22913486,60123496,7,0,0,34816,21,5842529412
6868,37222800,22743278,59966078,7,0,0,18944,21,6570528489
6869,37225550,22762942,59988492,1,0,0,2560,5,2779146831
6870,37226681,32394732,69621413,7,0,1,4096,21,6941247399
6871,37239810,22839911,60079721,5,0,0,2048,25,9052752286
6872,37243520,32425273,69668793,0,0,1,44032,8,1640649299
6873,37248150,22786253,60034403,5,0,0,1024,25,4904600753
6874,37250580,22968005,60218585,1,0,0,18432,5,5447440341
6875,37254230,32427009,69681239,0,0,1,12800,8,2083693019
6876,37265070,32488465,69753535,0,0,1,35328,8,6456174752
6877,37297390,32456168,69753558,4,0,1,5632,25,9766058403
6878,37302640,32450941,69753581,0,0,1,9728,8,2193117277
6879,37321860,32433803,69755663,0,0,1,40960,8,10441258503
6880,37336340,32461600,69797940,4,0,1,1024,25,4713554232
6881,37339150,22935216,60274366,7,0,0,49664,21,8483653966
6882,37343070,32458736,69801806,4,0,1,6144,25,3437725985
6883,37343440,23085898,60429338,7,0,0,22528,21,4572133225
6884,37348509,32453963,69802472,8,0,1,1024,1,7296149270
6885,37349400,23038691,60388091,1,0,0,17408,5,6543789415
6886,37358450,23059688,60418138,1,0,0,46080,5,10561435732
6887,37364560,32440844,69805404,0,0,1,4608,8,9274788950
6888,37367360,22888864,60256224,1,0,0,110592,5,1191365173
6889,37376480,22882731,60259211,7,0,0,9728,21,6312290962
6890,37395369,32410701,69806070,8,0,1,1024,1,5882706340
6891,37404950,32403540,69808490,4,0,1,12288,25,8177255307
6892,37409990,32398846,69808836,4,0,1,512,25,10247060602
6893,37413910,32406571,69820481,4,0,1,6656,25,409956190
6894,37419789,32401358,69821147,8,0,1,1024,1,9966556246
6895,37420429,32405544,69825973,8,0,1,7680,1,4578777678
6896,37441059,32416101,69857160,1,0,1,16896,5,7487289284
6897,37449950,32410436,69860386,0,0,1,5120,8,9900212925
6898,37455670,32408390,69864060,4,0,1,16384,25,18740983
6899,37455819,32411467,69867286,1,0,1,5120,5,4121674282
6900,37455960,32454092,69910052,4,0,1,7168,25,4046614022
6901,37457390,23069286,60526676,7,0,0,38400,21,4481155651
6902,37473459,32437107,69910566,8,0,1,7680,1,10402206281
6903,37479750,22923967,60403717,1,0,0,42496,5,84659669
6904,37480770,32429819,69910589,4,0,1,3072,25,384126619
6905,37481009,32429603,69910612,8,0,1,7168,1,9447161007
6906,37482690,22854021,60336711,5,0,0,2560,25,6284609062
6907,37483280,32427355,69910635,4,0,1,1024,25,9434657234
6908,37483450,22920602,60404052,5,0,0,1024,25,4299908304
6909,37483790,32426868,69910658,3,0,1,10240,21,5211089530
6910,37486730,22982370,60469100,1,0,0,10752,5,6613017687
6911,37488741,32422275,69911016,7,0,1,5120,21,6379605935
6912,37496219,32414844,69911063,1,0,1,13824,5,2430830975
6913,37498160,32418982,69917142,3,0,1,6656,21,3464766546
6914,37507729,32414863,69922592,8,0,1,1536,1,1057447468
6915,37513370,23301524,60814894,5,0,0,512,25,5237794887
6916,37513930,23064436,60578366,6,0,0,512,17,3255897066
6917,37522130,23141305,60663435,1,0,0,34816,5,1807225614
6918,37524989,32420684,69945673,1,0,1,7168,5,7488966769
6919,37529120,32429831,69958951,4,0,1,10752,25,2119696509
6920,37530459,32447831,69978290,8,0,1,1024,1,4087900165
6921,37534150,32445766,69979916,4,0,1,2560,25,6824501823
6922,37535180,23206363,60741543,7,0,0,81920,21,7947638103
6923,37541791,32448581,69990372,7,0,1,3072,21,7806838780
6924,37546940,32445698,69992638,3,0,1,3584,21,5986528641
6925,37549930,23050545,60600475,5,0,0,512,25,7090694216
6926,37552040,32441584,69993624,4,0,1,1536,25,1813884090
6927,37558649,32437241,69995890,1,0,1,3584,5,2539564015
6928,37563290,23227984,60791274,5,0,0,1024,25,9462324082
6929,37563780,32433416,69997196,3,0,1,2048,21,5863009128
6930,37568690,23354086,60922776,5,0,0,512,25,10108026262
6931,37573569,32424933,69998502,1,0,1,2048,5,1186589294
6932,37576891,32495418,70072309,5,0,1,138752,25,6441904017
6933,37577700,23413858,60991558,7,0,0,83456,21,464604295
6934,37598159,32477376,70075535,1,0,1,5120,5,2686752140
6935,37606010,23408971,61014981,1,0,0,76800,5,5958874891
6936,37610549,32496555,70107104,1,0,1,2048,5,9366337383
6937,37629800,23407447,61037247,6,0,0,2048,17,4794025388
6938,37639891,32469159,70109050,7,0,1,3072,21,3710873332
6939,37653170,23181825,60834995,1,0,0,6656,5,203050675
6940,37668000,23276037,60944037,6,0,0,1536,17,2996226756
6941,37678910,23793213,61472123,1,0,0,34816,5,806978016
6942,37685280,23099883,60785163,5,0,0,1024,25,4861433430
6943,37688480,23367503,61055983,1,0,0,22016,5,547654017
6944,37693141,32416268,70109409,7,0,1,9728,21,9686547513
6945,37693220,23328203,61021423,1,0,0,18944,5,2618916333
6946,37697700,32428980,70126680,3,0,1,8192,21,776997816
6947,37699810,23252012,60951822,5,0,0,512,25,5272985104
6948,37705200,23335346,61040546,7,0,0,10752,21,9830626018
6949,37709470,23423779,61133249,1,0,0,54784,5,8694708728
6950,37719300,23317268,61036568,6,0,0,3584,17,1915313669
6951,37730690,23220953,60951643,7,0,0,9216,21,5701440978
6952,37740150,23295257,61035407,1,0,0,41984,5,335449941
6953,37740980,32388606,70129586,3,0,1,4608,21,1708758861
6954,37765180,23046642,60811822,5,0,0,512,25,8605293640
6955,37765901,32367231,70133132,7,0,1,5632,21,56110860
6956,37771051,32362747,70133798,7,0,1,1024,21,4019894429
6957,37771420,23244208,61015628,6,0,0,2048,17,9151056417
6958,37785670,23272261,61057931,5,0,0,1024,25,7523372354
6959,37798310,23242937,61041247,5,0,0,1536,25,7458223151
6960,37798390,23335529,61133919,6,0,0,1536,17,7885215413
6961,37800200,23240525,61040725,6,0,0,512,17,5728084722
6962,37813470,23298052,61111522,6,0,0,512,17,994761116
6963,37816140,23644986,61461126,7,0,0,82944,21,6145047080
6964,37817731,32317373,70135104,7,0,1,2048,21,3173439603
6965,37827590,23233373,61060963,6,0,0,3072,17,6595117438
6966,37829550,32305900,70135450,3,0,1,512,21,7503942874
6967,37833940,23387014,61220954,7,0,0,22528,21,6151562770
6968,37848190,23174402,61022592,6,0,0,512,17,246226296
6969,37861569,32277107,70138676,1,0,1,5120,5,8901951773
6970,37881320,23235003,61116323,6,0,0,512,17,3458410029
6971,37897470,32257722,70155192,2,0,1,12800,19,1002684312
6972,37901240,23304565,61205805,5,0,0,1536,25,9693728553
6973,37904980,23152371,61057351,6,0,0,1024,17,4519954152
6974,37905080,23117302,61022382,6,0,0,3072,17,588166937
6975,37907680,23297634,61205314,1,0,0,39936,5,10482857477
6976,37912290,23252801,61165091,7,0,0,7680,21,2750442048
6977,37917470,23167715,61085185,6,0,0,512,17,9171172068
6978,37918360,23215068,61133428,5,0,0,512,25,10340409178
6979,37920559,32277088,70197647,1,0,1,1536,5,2715642670
6980,37921840,23380290,61302130,7,0,0,35840,21,1001909662
6981,37924590,32273080,70197670,3,0,1,512,21,2219768209
6982,37930520,32279832,70210352,9,0,1,16896,4,2207556549
6983,37947720,32262655,70210375,3,0,1,512,21,4116411355
6984,37976560,23189893,61166453,6,0,0,512,17,5457760870
6985,37978480,32231926,70210406,3,0,1,4608,21,145526265
6986,37980840,23495959,61476799,5,0,0,512,25,8218734082
6987,37981170,23273069,61254239,5,0,0,1024,25,8590458051
6988,37982020,32228409,70210429,3,0,1,3584,21,8231643556
6989,37986760,23265647,61252407,7,0,0,11264,21,1260101767
6990,37993520,23247307,61240827,5,0,0,512,25,1229298504
6991,38002140,32208491,70210631,3,0,1,4096,21,322134642
6992,38006370,23358308,61364678,9,0,0,512,4,2125076523
6993,38010430,23218735,61229165,6,0,0,512,17,3403164372
6994,38033880,23391769,61425649,1,0,0,37888,5,2548492457
6995,38034680,23329819,61364499,7,0,0,6144,21,734232541
6996,38044489,32166165,70210654,6,0,1,10752,17,1486315779
6997,38046410,23448978,61495388,7,0,0,13312,21,7883311726
6998,38046889,32171788,70218677,6,0,1,3072,17,10337636722
6999,38054580,23544082,61598662,7,0,0,11776,21,8320015251
7000,38065100,23174574,61239674,6,0,0,2560,17,8592207870
7001,38071609,32147990,70219599,6,0,1,10240,17,4332210732
7002,38073650,23320676,61394326,9,0,0,512,4,836403021
7003,38073780,23288824,61362604,1,0,0,73728,5,4304093410
7004,38074500,23520551,61595051,7,0,0,36864,21,2724248794
7005,38078280,23187210,61265490,6,0,0,2048,17,9969607469
7006,38080540,32139405,70219945,3,0,1,512,21,2844036945
7007,38083740,23377573,61461313,6,0,0,512,17,8725020634
7008,38084240,23451211,61535451,5,0,0,1024,25,5653668290
7009,38088400,23577064,61665464,5,0,0,1536,25,7429117970
7010,38101630,32120581,70222211,3,0,1,3584,21,5405270022
7011,38103069,32122519,70225588,8,0,1,512,1,9379608331
7012,38113880,23267819,61381699,9,0,0,1536,4,7667538000
7013,38114919,32112615,70227534,6,0,1,3072,17,5600404119
7014,38115050,32152058,70267108,3,0,1,512,21,8559914079
7015,38121039,32148015,70269054,6,0,1,3072,17,8339322180
7016,38121450,32148270,70269720,9,0,1,1024,4,1002899692
7017,38124949,32187075,70312024,6,0,1,22016,17,3741731609
7018,38134400,23276712,61411112,9,0,0,512,4,1017938276
7019,38143110,23521863,61664973,7,0,0,22016,21,1760141202
7020,38146740,23314752,61461492,9,0,0,512,4,3379082046
7021,38153300,32173884,70327184,9,0,1,2048,4,842313564
7022,38179580,32148270,70327850,9,0,1,1024,4,2165384560
7023,38189150,23437894,61627044,9,0,0,512,4,2746319368
7024,38192070,32135934,70328004,3,0,1,8704,21,3120320216
7025,38194550,23433054,61627604,9,0,0,1536,4,9879196605
7026,38195400,23431442,61626842,7,0,0,92160,21,7702376337
7027,38199829,32144551,70344380,6,0,1,3072,17,9805571092
7028,38209069,32136617,70345686,6,0,1,2048,17,1264984127
7029,38214240,23221591,61435831,1,0,0,512,5,6218681426
7030,38221510,23436732,61658242,9,0,0,2560,4,3937067238
7031,38223909,32126603,70350512,8,0,1,7680,1,1601984092
7032,38226980,32123878,70350858,3,0,1,512,21,6970283423
7033,38227950,23206616,61434566,1,0,0,1024,5,10206840519
7034,38234070,23271326,61505396,6,0,0,512,17,8999251427
7035,38239879,32127667,70367546,6,0,1,5632,17,2878926859
7036,38247201,23410238,61657439,2,0,0,56832,19,916365897
7037,38255230,32113726,70368956,9,0,1,7168,4,4382263129
7038,38256261,23550401,61806662,2,0,0,43008,19,10633188877
7039,38257920,23370042,61627962,1,0,0,1024,5,677569051
7040,38258410,23614110,61872520,1,0,0,512,5,8433770773
7041,38261001,32110541,70371542,7,0,1,4096,21,6055569336
7042,38267600,23300654,61568254,5,0,0,512,25,7938049237
7043,38268340,32119927,70388267,3,0,1,512,21,3308555570
7044,38269091,23564389,61833480,2,0,0,20992,19,5086406063
7045,38269909,32131004,70400913,6,0,1,12288,17,259169578
7046,38271590,32133509,70405099,3,0,1,6656,21,2070898444
7047,38272629,32146774,70419403,6,0,1,2048,17,9644985433
7048,38273940,23442119,61716059,6,0,0,1024,17,1957273821
7049,38274049,32201234,70475283,1,0,1,19456,5,1267060220
7050,38275020,32201249,70476269,3,0,1,1536,21,9344807363
7051,38275850,32200983,70476833,3,0,1,10752,21,6357148316
7052,38287330,23571343,61858673,1,0,0,1536,5,1677340592
7053,38291700,23463214,61754914,5,0,0,512,25,2724736089
7054,38297340,32200486,70497826,3,0,1,1024,21,3211617993
7055,38301680,32275816,70577496,3,0,1,6656,21,9351889975
7056,38305529,32274233,70579762,6,0,1,3584,17,9154081030
7057,38310289,32271099,70581388,1,0,1,2560,5,2114365823
7058,38312940,23441795,61754735,7,0,0,27136,21,1032376991
7059,38314460,32278929,70593389,3,0,1,5120,21,3120183196
7060,38314629,32287896,70602525,1,0,1,16896,5,3248686854
7061,38316921,32312796,70629717,7,0,1,1024,21,3402193407
7062,38317101,23541073,61858174,2,0,0,15872,19,10037174196
7063,38318140,23619529,61937669,7,0,0,63488,21,4285968591
7064,38318880,23383431,61702311,5,0,0,512,25,5060105358
7065,38320230,23538622,61858852,1,0,0,512,5,8652902333
7066,38326160,32303759,70629919,3,0,1,3072,21,475927166
7067,38335259,32294683,70629942,6,0,1,3072,17,9634536177
7068,38339310,23768593,62107903,6,0,0,2048,17,4757574420
7069,38340879,32289086,70629965,8,0,1,8192,1,1790216492
7070,38341890,32299058,70640948,3,0,1,1536,21,1622914943
7071,38351151,23502164,61853315,2,0,0,65024,19,7549878095
7072,38352979,32291835,70644814,6,0,1,6144,17,69518863
7073,38354160,23685977,62040137,7,0,0,11776,21,10550535760
7074,38356839,32288129,70644968,6,0,1,8704,17,872422238
7075,38362999,32291784,70654783,6,0,1,512,17,7296520676
7076,38363789,32292620,70656409,1,0,1,2560,5,2537369590
7077,38377770,23560078,61937848,5,0,0,512,25,9547364980
7078,38385539,32273646,70659185,8,0,1,4096,1,2617741951
7079,38387069,32306818,70693887,1,0,1,2560,5,4998572897
7080,38394069,32299857,70693926,6,0,1,512,17,9813323233
7081,38394590,23603056,61997646,9,0,0,1536,4,4954567192
7082,38395390,32298559,70693949,3,0,1,2048,21,9390951957
7083,38402659,32291313,70693972,6,0,1,6656,17,347165584
7084,38403610,23642478,62046088,7,0,0,19456,21,4448832403
7085,38409270,23493952,61903222,6,0,0,512,17,8481549885
7086,38413679,32280316,70693995,6,0,1,3584,17,7456366052
7087,38415170,23634685,62049855,7,0,0,12288,21,10081455647
7088,38419691,32274327,70694018,7,0,1,1024,21,4501342669
7089,38420021,23615956,62035977,2,0,0,31232,19,9161510237
7090,38421550,32275593,70697143,3,0,1,12288,21,10663708840
7091,38422080,23807155,62229235,7,0,0,73216,21,7143922424
7092,38424749,32290261,70715010,6,0,1,3072,17,6863012397
7093,38432091,32285505,70717596,7,0,1,4096,21,9751197226
7094,38432549,32398815,70831364,8,0,1,3584,1,3582088576
7095,38433971,23927459,62361430,2,0,0,63488,19,5393989785
7096,38436150,32426084,70862234,3,0,1,10752,21,1512325084
7097,38437029,32430438,70867467,6,0,1,7680,17,1299800463
7098,38437299,32430191,70867490,6,0,1,10752,17,3855870185
7099,38439500,23884451,62323951,6,0,0,2048,17,7621025366
7100,38441189,32447019,70888208,1,0,1,5120,5,8267361692
7101,38441709,32474284,70915993,1,0,1,5632,5,5036577115
7102,38447029,32468987,70916016,1,0,1,1024,5,6600013429
7103,38449880,32466159,70916039,3,0,1,512,21,2011873856
7104,38454020,23954676,62408696,7,0,0,23040,21,5764302557
7105,38464820,23908845,62373665,1,0,0,512,5,8678288154
7106,38466101,32449961,70916062,7,0,1,8704,21,4527507131
7107,38472640,32470401,70943041,3,0,1,3072,21,1201563463
7108,38475321,23795389,62270710,2,0,0,43008,19,914894085
7109,38485050,23697327,62182377,7,0,0,38400,21,8826974369
7110,38507789,32464201,70971990,1,0,1,27136,5,669073495
7111,38510209,32462447,70972656,6,0,1,11264,17,517383592
7112,38512480,24000640,62513120,7,0,0,35840,21,10041921929
7113,38512660,23790648,62303308,6,0,0,512,17,5949185830
7114,38513459,32494392,71007851,8,0,1,10240,1,5021070036
7115,38514740,23758373,62273113,5,0,0,512,25,2784740577
7116,38516240,24011815,62528055,7,0,0,47616,21,5080580312
7117,38523140,23659416,62182556,6,0,0,512,17,10333599688
7118,38526091,23724165,62250256,2,0,0,16896,19,9616563122
7119,38526291,32513301,71039592,7,0,1,1024,21,501844539
7120,38533690,23828456,62362146,1,0,0,512,5,7178453908
7121,38534241,23767360,62301601,2,0,0,25600,19,9246336562
7122,38535250,23826694,62361944,5,0,0,1536,25,7652863661
7123,38537351,32502702,71040053,7,0,1,10240,21,8571011873
7124,38537959,32530243,71068202,8,0,1,1024,1,7630211022
7125,38538831,24250112,62788943,2,0,0,47616,19,8644908760
7126,38539830,23788396,62328226,9,0,0,512,4,7781382199
7127,38542169,32527339,71069508,8,0,1,2048,1,4326861754
7128,38544980,23684590,62229570,9,0,0,1024,4,6326707314
7129,38547550,23913028,62460578,7,0,0,40960,21,8761534926
7130,38550501,32520313,71070814,7,0,1,2048,21,2489192702
7131,38553180,23782963,62336143,7,0,0,5120,21,10176713426
7132,38554101,32529247,71083348,7,0,1,7168,21,10709838506
7133,38566970,32516401,71083371,3,0,1,512,21,7755008189
7134,38569050,32533647,71102697,6,0,1,11264,17,5568762689
7135,38572421,24006517,62578938,2,0,0,63488,19,4392878451
7136,38575911,32608650,71184561,7,0,1,3584,21,10200779675
7137,38580841,32647658,71228499,7,0,1,18432,21,9752366049
7138,38581000,32648319,71229319,6,0,1,9728,17,283621967
7139,38586680,32646185,71232865,2,0,1,5632,19,5546572335
7140,38591830,23834920,62426750,1,0,0,512,5,1609863368
7141,38595190,32641221,71236411,3,0,1,5632,21,2629690195
7142,38597840,23538643,62136483,1,0,0,1024,5,4745143182
7143,38601660,32635737,71237397,3,0,1,1536,21,9997288017
7144,38611140,32629163,71240303,6,0,1,4608,17,5034628718
7145,38611760,23694776,62306536,1,0,0,1024,5,7367833887
7146,38618799,32636503,71255302,1,0,1,10752,5,5088744717
7147,38618829,32656145,71274974,1,0,1,2560,5,1722097734
7148,38619720,32658282,71278002,3,0,1,6144,21,10414427521
7149,38620910,32657860,71278770,2,0,1,11776,19,5800472279
7150,38623421,32683926,71307347,7,0,1,3584,21,7291422784
7151,38625040,23842579,62467619,7,0,0,15360,21,10444673798
7152,38625450,32681920,71307370,3,0,1,8704,21,5206252692
7153,38627310,23623749,62251059,1,0,0,2560,5,6393807489
7154,38627450,32682999,71310449,2,0,1,512,19,9233948224
7155,38628611,23761216,62389827,2,0,0,6144,19,6796506352
7156,38632751,23962777,62595528,2,0,0,53760,19,368735407
7157,38636010,23943115,62579125,9,0,0,512,4,9840668297
7158,38636969,32673503,71310472,6,0,1,1536,17,3095368294
7159,38639461,32671066,71310527,7,0,1,7680,21,3379860172
7160,38642390,23818546,62460936,1,0,0,1024,5,6192375230
7161,38644990,23883337,62528327,1,0,0,512,5,3079437998
7162,38646181,32664472,71310653,7,0,1,1536,21,294143887
7163,38649971,32662948,71312919,7,0,1,3584,21,2977464963
7164,38662660,23850795,62513455,9,0,0,1024,4,9038419396
7165,38675689,32638536,71314225,1,0,1,2048,5,6352322722
7166,38697900,23916904,62614804,6,0,0,512,17,1944642353
7167,38698460,23991199,62689659,7,0,0,12288,21,4772526946
7168,38698779,32620272,71319051,1,0,1,7680,5,16109911
7169,38699590,23769042,62468632,6,0,0,512,17,10384961391
7170,38699629,32621053,71320682,1,0,1,2560,5,10579887074
7171,38700850,32621133,71321983,3,0,1,2048,21,6027969204
7172,38705410,23795989,62501399,6,0,0,512,17,4641268573
7173,38708101,32616084,71324185,7,0,1,12288,21,2714817401
7174,38711930,24121319,62833249,9,0,0,1536,4,5907975446
7175,38715250,23889248,62604498,7,0,0,6656,21,9151953738
7176,38719899,32614495,71334394,1,0,1,4096,5,8155508073
7177,38720619,32614441,71335060,1,0,1,1024,5,10451986477
7178,38724950,32610776,71335726,9,0,1,1024,4,9192328081
7179,38730561,24036014,62766575,2,0,0,41472,19,8107585317
7180,38737540,32601412,71338952,3,0,1,5120,21,8223858772
7181,38743661,32628454,71372115,7,0,1,24064,21,4796223617
7182,38744989,32739027,71484016,1,0,1,1536,5,7923413718
7183,38751371,24080952,62832323,2,0,0,51712,19,3052644125
7184,38756980,23980265,62737245,6,0,0,512,17,8995994024
7185,38758869,32804181,71563050,6,0,1,5632,17,6897428755
7186,38768440,23875998,62644438,6,0,0,512,17,8007777778
7187,38769771,23903392,62673163,2,0,0,31744,19,9311305114
7188,38773200,23832498,62605698,1,0,0,512,5,3323448141
7189,38774681,32788392,71563073,7,0,1,2048,21,7981303956
7190,38776860,23782711,62559571,9,0,0,1536,4,2787618174
7191,38782960,23922713,62705673,9,0,0,1024,4,10059739438
7192,38783600,32779512,71563112,2,0,1,9728,19,3396136951
7193,38787680,24135324,62923004,1,0,0,1024,5,7167404852
7194,38792750,32775658,71568408,3,0,1,8192,21,3699383860
7195,38796131,32772943,71569074,7,0,1,1024,21,9605308864
7196,38797080,32952479,71749559,6,0,1,15872,17,1143383490
7197,38808490,24008031,62816521,7,0,0,31744,21,3412362652
7198,38812410,32937172,71749582,6,0,1,3072,17,1916363114
7199,38815400,24085315,62900715,6,0,0,512,17,3611419432
7200,38816100,32933505,71749605,9,0,1,7680,4,8701725739
7201,38820401,32938500,71758901,7,0,1,2048,21,10535095550
7202,38837280,23995230,62832510,6,0,0,512,17,5314761254
7203,38845260,32913664,71758924,6,0,1,5632,17,1055944115
7204,38846580,23852205,62698785,6,0,0,1536,17,5702552529
7205,38848490,24106908,62955398,7,0,0,61952,21,4525075210
7206,38848680,23843649,62692329,1,0,0,512,5,10197927371
7207,38849680,24080705,62930385,1,0,0,1024,5,10469712389
7208,38864160,32894787,71758947,6,0,1,5632,17,8173229945
7209,38867521,32891449,71758970,7,0,1,1536,21,8605847232
7210,38873040,23980072,62853112,1,0,0,1024,5,4393452136
7211,38883919,32875074,71758993,8,0,1,5632,1,8753677645
7212,38884050,24091385,62975435,7,0,0,45056,21,2270905657
7213,38894231,24006305,62900536,2,0,0,23040,19,6063943350
7214,38899610,32859406,71759016,3,0,1,1024,21,6885346910
7215,38903360,23808606,62711966,6,0,0,512,17,812896443
7216,38904280,24056913,62961193,7,0,0,18944,21,5278414955
7217,38904330,23971146,62875476,6,0,0,512,17,6587135513
7218,38904930,32854109,71759039,2,0,1,13312,19,1216131927
7219,38909081,32849981,71759062,7,0,1,1024,21,10561979601
7220,38914060,32845025,71759085,3,0,1,1536,21,5431528977
7221,38918621,32846617,71765238,7,0,1,7168,21,8504428878
7222,38919381,32863687,71783068,7,0,1,1536,21,166542282
7223,38921990,32861101,71783091,6,0,1,4096,17,58984873
7224,38924130,23865148,62789278,6,0,0,1024,17,10443873362
7225,38925440,24036244,62961684,9,0,0,1536,4,5356693462
7226,38934350,23989316,62923666,9,0,0,2048,4,7920012746
7227,38936871,32846243,71783114,7,0,1,3584,21,9372214314
7228,38938560,24116704,63055264,7,0,0,38400,21,7179698987
7229,38940021,32856173,71796194,7,0,1,7168,21,12690921
7230,38946781,32861878,71808659,7,0,1,1536,21,7907578338
7231,38950140,23882572,62832712,9,0,0,512,4,6674100220
7232,38952020,23904447,62856467,6,0,0,1536,17,8050971213
7233,38954729,32853953,71808682,8,0,1,2048,1,10275459942
7234,38975919,32832786,71808705,8,0,1,4096,1,2743182787
7235,38978121,23951118,62929239,2,0,0,7680,19,9887819693
7236,38983150,24077326,63060476,1,0,0,512,5,7525855086
7237,38992410,32816318,71808728,3,0,1,13824,21,9907818649
7238,38998570,32810712,71809282,2,0,1,17408,19,734712952
7239,39024400,23905018,62929418,1,0,0,512,5,4032629922
7240,39038210,32799018,71837228,9,0,1,28672,4,4096201861
7241,39046480,24123023,63169503,7,0,0,57344,21,5107943677
7242,39053900,32801541,71855441,9,0,1,3584,4,5805015463
7243,39054711,23940184,62994895,2,0,0,10752,19,2406664413
7244,39056769,32799018,71855787,8,0,1,512,1,9053285179
7245,39063980,32795033,71859013,9,0,1,5120,4,6272849520
7246,39067330,32794589,71861919,9,0,1,4608,4,3919899089
7247,39067450,24073543,63140993,9,0,0,512,4,9524847254
7248,39068020,24082168,63150188,6,0,0,1024,17,1032159693
7249,39068130,24137400,63205530,1,0,0,2048,5,5827592285
7250,39069400,24154895,63224295,1,0,0,512,5,9597527088
7251,39073291,32789934,71863225,5,0,1,2048,25,7321873485
7252,39081610,32783241,71864851,3,0,1,2560,21,2963726591
7253,39081989,32829735,71911724,6,0,1,16896,17,9450515644
7254,39084550,32829120,71913670,9,0,1,3072,4,3542397193
7255,39088900,24080984,63169884,1,0,0,1024,5,61059423
7256,39089131,24224189,63313320,2,0,0,52224,19,2869147405
7257,39091129,32827047,71918176,8,0,1,7168,1,8249358735
7258,39097190,24022673,63119863,6,0,0,512,17,5163873508
7259,39099431,32869935,71969366,5,0,1,12800,25,7168586220
7260,39101040,32868672,71969712,9,0,1,512,4,9765432302
7261,39107330,32864328,71971658,3,0,1,3072,21,9696623227
7262,39107980,32865944,71973924,6,0,1,3584,17,629569743
7263,39110541,32907564,72018105,5,0,1,9728,25,9486723760
7264,39111070,24128032,63239102,6,0,0,1024,17,5998141163
7265,39111241,32907325,72018566,5,0,1,10240,25,6078820422
7266,39124321,24159266,63283587,2,0,0,33792,19,7106557962
7267,39126721,24124123,63250844,2,0,0,6656,19,1452170405
7268,39131269,32891163,72022432,8,0,1,6144,1,3006575058
7269,39134950,24287160,63422110,7,0,0,1536,21,8215781713
7270,39135090,32888968,72024058,9,0,1,2560,4,4209292823
7271,39136230,32891374,72027604,6,0,1,5632,17,8070056666
7272,39147629,32881358,72028987,8,0,1,14848,1,2142134328
7273,39148500,32979914,72128414,9,0,1,6144,4,2952410325
7274,39158290,32970147,72128437,9,0,1,1536,4,2131199749
7275,39164361,33161680,72326041,5,0,1,74752,25,3685943060
7276,39166070,33177691,72343761,9,0,1,3584,4,5224713623
7277,39170929,33172855,72343784,8,0,1,512,1,3756921675
7278,39173050,33170757,72343807,6,0,1,14848,17,5110596126
7279,39178880,33214976,72393856,9,0,1,2560,4,3891247373
7280,39182590,33232078,72414668,9,0,1,21504,4,1525517398
7281,39187910,24155022,63342932,6,0,0,1024,17,4456721850
7282,39190550,33232803,72423353,6,0,1,5120,17,7735748486
7283,39199661,33236278,72435939,5,0,1,6144,25,6265047806
7284,39218570,33244510,72463080,9,0,1,4608,4,6874565324
7285,39222280,33240823,72463103,6,0,1,16384,17,3809791670
7286,39239560,24425482,63665042,7,0,0,93184,21,3226876495
7287,39240759,33222367,72463126,6,0,1,2560,17,8372141701
7288,39244190,24292838,63537028,7,0,0,50688,21,6929618361
7289,39244200,24171842,63416042,1,0,0,1024,5,4702174227
7290,39248090,24254030,63502120,7,0,0,31744,21,4045197937
7291,39250650,24234983,63485633,8,0,0,512,1,739618666
7292,39257330,33205819,72463149,3,0,1,3072,21,9028063890
7293,39261950,24367128,63629078,1,0,0,512,5,4487934984
7294,39264781,24419963,63684744,2,0,0,64512,19,5889345768
7295,39266210,24271153,63537363,9,0,0,1024,4,3246675705
7296,39267620,24340393,63608013,7,0,0,10240,21,2838258837
7297,39269300,24365766,63635066,9,0,0,512,4,9244977184
7298,39272251,33190921,72463172,5,0,1,14336,25,5411869889
7299,39273640,24419909,63693549,7,0,0,28672,21,7407070667
7300,39279819,33322429,72602248,3,0,1,10752,21,6460092533
7301,39280230,33322274,72602504,3,0,1,9216,21,8000079540
7302,39282741,33577962,72860703,5,0,1,100864,25,6972735162
7303,39288969,33571757,72860726,6,0,1,6144,17,1449461638
7304,39294330,33593300,72887630,9,0,1,16384,4,2288440326
7305,39304620,33677225,72981845,3,0,1,2560,21,1623683605
7306,39310069,33671799,72981868,6,0,1,2048,17,558182337
7307,39310619,33671272,72981891,1,0,1,5120,5,6315868208
7308,39315621,33685433,73001054,5,0,1,24576,25,8557942029
7309,39317620,24496440,63814060,6,0,0,512,17,988618760
7310,39323700,24545278,63868978,1,0,0,512,5,876681721
7311,39324049,33677028,73001077,3,0,1,3072,21,4640401345
7312,39325981,33675159,73001140,5,0,1,4608,25,6005376124
7313,39326230,24595513,63921743,9,0,0,2048,4,1260829534
7314,39331180,24509396,63840576,7,0,0,3072,21,6984950988
7315,39345069,33657697,73002766,1,0,1,2560,5,1278334276
7316,39346561,33708612,73055173,5,0,1,27136,25,973966307
7317,39346780,33708416,73055196,3,0,1,2048,21,1533143522
7318,39347519,33726181,73073700,6,0,1,1536,17,5255030556
7319,39353469,33721217,73074686,1,0,1,1536,5,1203519794
7320,39354179,33751456,73105635,1,0,1,7680,5,9432449998
7321,39354981,33750677,73105658,5,0,1,40448,25,1499342855
7322,39357000,24579829,63936829,9,0,0,512,4,9872309010
7323,39362150,33761599,73123749,9,0,1,512,4,201238881
7324,39363270,33762849,73126119,9,0,1,5632,4,3036230231
7325,39366320,24767234,64133554,9,0,0,512,4,3303022962
7326,39369801,24697216,64067017,2,0,0,8192,19,1306759238
7327,39376930,24646282,64023212,6,0,0,1536,17,6245024202
7328,39378330,24791775,64170105,7,0,0,15360,21,6459286870
7329,39381729,33752347,73134076,3,0,1,1536,21,8387455163
7330,39382880,24748696,64131576,7,0,0,4608,21,4109945799
7331,39387580,24763882,64151462,9,0,0,512,4,5809797486
7332,39388291,33762306,73150597,5,0,1,11776,25,6672272859
7333,39388460,33800201,73188661,2,0,1,2560,19,1376172760
7334,39390700,33802147,73192847,6,0,1,6656,17,3566288084
7335,39396040,33800993,73197033,9,0,1,6656,4,1316718975
7336,39397100,33827731,73224831,0,0,1,512,8,7750899451
7337,39398421,24920737,64319158,2,0,0,63488,19,8452342166
7338,39403220,24944460,64347680,7,0,0,27648,21,9588254769
7339,39404510,24628178,64032688,1,0,0,512,5,4538710141
7340,39408029,33816825,73224854,6,0,1,512,17,5058750323
7341,39421759,33807197,73228956,6,0,1,4096,17,6452940856
7342,39422751,24826446,64249197,2,0,0,14848,19,2466733963
7343,39424989,33803990,73228979,6,0,1,2048,17,1155640189
7344,39425551,33843596,73269147,5,0,1,40448,25,6121090045
7345,39426620,24798049,64224669,6,0,0,1536,17,9643553117
7346,39429311,24926824,64356135,2,0,0,27648,19,1981194894
7347,39444079,33825091,73269170,1,0,1,6656,5,2271196884
7348,39446390,33822803,73269193,9,0,1,7168,4,1936447310
7349,39455941,24883292,64339233,2,0,0,5632,19,5057082241
7350,39472660,33796556,73269216,9,0,1,512,4,442216187
7351,39475250,25544906,65020156,7,0,0,32768,21,3959508696
7352,39476050,24843466,64319516,6,0,0,1024,17,6441925246
7353,39478139,33791100,73269239,6,0,1,512,17,6474711357
7354,39493179,33776083,73269262,6,0,1,2560,17,10063447944
7355,39499579,33770545,73270124,6,0,1,1536,17,8717916415
7356,39501460,33769330,73270790,9,0,1,1024,4,2575207824
7357,39509779,33762637,73272416,6,0,1,2560,17,7503694298
7358,39513419,33762223,73275642,6,0,1,5120,17,1607648023
7359,39517200,33760388,73277588,0,0,1,3072,8,4624497265
7360,39518251,25126502,64644753,2,0,0,35840,19,304018448
7361,39522600,33929590,73452190,2,0,1,1024,19,2577932153
7362,39526439,34244916,73771355,6,0,1,6656,17,7697127002
7363,39527259,34306627,73833886,1,0,1,3072,5,1571214621
7364,39533900,24851368,64385268,9,0,0,512,4,3402213622
7365,39534400,25579727,65114127,6,0,0,2048,17,10457285380
7366,39537320,24902930,64440250,1,0,0,1024,5,602579865
7367,39543459,34290450,73833909,6,0,1,14336,17,7225452968
7368,39556271,25077040,64633311,2,0,0,105472,19,3127995548
7369,39560110,34273822,73833932,0,0,1,2048,8,4688375241
7370,39570930,34273188,73844118,2,0,1,3072,19,6547769352
7371,39595010,24847410,64442420,9,0,0,512,4,9156433354
7372,39604840,34239301,73844141,2,0,1,8704,19,9383444759
7373,39615279,34313503,73928782,6,0,1,5120,17,2955849780
7374,39625870,24738697,64364567,9,0,0,1024,4,3687064925
7375,39631869,34416166,74048035,1,0,1,17920,5,7685434908
7376,39664980,34492335,74157315,2,0,1,4608,19,9880196948
7377,39666200,25112856,64779056,7,0,0,188416,21,1791046255
7378,39668241,34490338,74158579,5,0,1,14848,25,3071586481
7379,39668500,24757533,64426033,1,0,0,512,5,9185776993
7380,39670180,34598471,74268651,2,0,1,1536,19,7862825477
7381,39679730,34588944,74268674,2,0,1,7680,19,9011218761
7382,39699541,34762537,74462078,7,0,1,17408,21,1376300145
7383,39701530,34851977,74553507,2,0,1,19456,19,5758218639
7384,39702710,34876606,74579316,2,0,1,4096,19,7443322239
7385,39720370,25446197,65166567,6,0,0,512,17,3666772747
7386,39727070,25410127,65137197,6,0,0,1024,17,2484595486
7387,39732581,25144727,64877308,2,0,0,47616,19,2665816204
7388,39735691,25290501,65026192,2,0,0,19456,19,635047891
7389,39741560,24853972,64595532,9,0,0,512,4,4819389155
7390,39743661,25266488,65010149,2,0,0,62464,19,7005976008
7391,39745691,34833664,74579355,7,0,1,8704,21,5132349836
7392,39752850,24847722,64600572,1,0,0,512,5,6616793612
7393,39755020,34824358,74579378,2,0,1,512,19,1336231961
7394,39762480,24745158,64507638,1,0,0,512,5,10672678368
7395,39769530,24829506,64599036,6,0,0,512,17,3679050253
7396,39770281,34842324,74612605,7,0,1,45056,21,10130906762
7397,39779541,34844365,74623906,7,0,1,5120,21,10500282279
7398,39781990,34845722,74627712,2,0,1,2560,19,6386241503
7399,39785760,24916220,64701980,9,0,0,2560,4,3217304885
7400,39801190,25004596,64805786,7,0,0,85504,21,5176994474
7401,39804780,25008072,64812852,7,0,0,22016,21,427521737
7402,39805741,34821994,74627735,7,0,1,11776,21,1320035387
7403,39808500,24890286,64698786,6,0,0,512,17,2105955043
7404,39815100,24906525,64721625,1,0,0,1024,5,1157451648
7405,39818110,25135328,64953438,7,0,0,29696,21,1903133240
7406,39818371,24961340,64779711,2,0,0,2048,19,1434422425
7407,39821600,24996292,64817892,9,0,0,3072,4,2024748375
7408,39835611,34831201,74666812,7,0,1,3072,21,6860865749
7409,39847860,25080434,64928294,6,0,0,512,17,3309169677
7410,39848610,25093378,64941988,7,0,0,27648,21,4171244015
7411,39851700,24782110,64633810,9,0,0,1536,4,6040359256
7412,39854321,25173009,65027330,2,0,0,3584,19,10212159452
7413,39858370,25132655,64991025,6,0,0,512,17,4323928991
7414,39869001,34797834,74666835,7,0,1,17408,21,9871342547
7415,39874450,24986449,64860899,6,0,0,512,17,5611423278
7416,39878100,24928021,64806121,1,0,0,1024,5,6628703890
7417,39895700,24992410,64888110,1,0,0,512,5,284492
7418,39902021,34794876,74696897,7,0,1,21504,21,2959748313
7419,39924570,25251008,65175578,1,0,0,2560,5,5328047546
7420,39927230,34787069,74714299,9,0,1,9216,4,1705691994
7421,39940721,34808175,74748896,7,0,1,2560,21,8574437308
7422,39942191,25048609,64990800,2,0,0,109568,19,546706713
7423,39947151,34864507,74811658,7,0,1,41984,21,9193928555
7424,39953060,34859904,74812964,9,0,1,2048,4,8388355284
7425,39960720,25407250,65367970,7,0,0,138240,21,9667985847
7426,39970641,25290219,65260860,2,0,0,3584,19,2828764801
7427,39978001,24837095,64815096,2,0,0,6656,19,8925758725
7428,39983640,34833830,74817470,4,0,1,7168,25,4483412491
7429,39990400,25253870,65244270,7,0,0,76288,21,6037367848
7430,39994610,25321603,65316213,6,0,0,512,17,10020514453
7431,40001020,25195932,65196952,1,0,0,1024,5,8382605408
7432,40001490,25026331,65027821,1,0,0,1536,5,8986740708
7433,40016460,34801996,74818456,9,0,1,1536,4,6619278450
7434,40017381,34952169,74969550,7,0,1,99328,21,3927530996
7435,40020580,24911834,64932414,6,0,0,1024,17,9820967197
7436,40021100,25097155,65118255,6,0,0,512,17,4832174383
7437,40022861,35002208,75025069,7,0,1,11776,21,1915592891
7438,40035190,35017887,75053077,9,0,1,9728,4,8751246257
7439,40038040,35015068,75053108,9,0,1,3584,4,1403931426
7440,40039760,25248861,65288621,6,0,0,1536,17,9487429593
7441,40044600,25358899,65403499,7,0,0,51712,21,10138000855
7442,40049250,35003881,75053131,9,0,1,13312,4,101916006
7443,40053060,25067739,65120799,6,0,0,1536,17,1345547888
7444,40062810,35002042,75064852,9,0,1,1536,4,10471829625
7445,40071610,34997065,75068675,9,0,1,7680,4,6323893944
7446,40072550,25295668,65368218,9,0,0,512,4,2836760677
7447,40079780,25498449,65578229,7,0,0,67584,21,2558783896
7448,40081659,25338706,65420365,3,0,0,5120,21,3913141785
7449,40089590,25278807,65368397,6,0,0,512,17,6583363331
7450,40095140,25382789,65477929,7,0,0,32256,21,4547125671
7451,40099300,24983501,65082801,6,0,0,512,17,2852507527
7452,40103130,25070912,65174042,6,0,0,2560,17,3610079178
7453,40113841,25191045,65304886,2,0,0,16384,19,8866095974
7454,40115490,34964873,75080363,9,0,1,2560,4,7939211040
7455,40116430,25547696,65664126,7,0,0,67072,21,8038527619
7456,40123141,25253414,65376555,2,0,0,26112,19,9078420249
7457,40137131,25624963,65762094,2,0,0,13312,19,2991888801
7458,40152850,34975905,75128755,9,0,1,14336,4,9862580579
7459,40153040,25017922,65170962,9,0,0,2048,4,4060528008
7460,40155800,25511584,65667384,6,0,0,1024,17,7109766365
7461,40164010,24951173,65115183,6,0,0,512,17,4794739754
7462,40179231,25516449,65695680,2,0,0,8192,19,3536002988
7463,40181920,34946858,75128778,9,0,1,3072,4,7693110893
7464,40185070,25578037,65763107,1,0,0,512,5,972138442
7465,40185540,25305772,65491312,6,0,0,512,17,7211849783
7466,40187260,34941541,75128801,9,0,1,11264,4,8087174134
7467,40192340,25211673,65404013,6,0,0,1536,17,8677283371
7468,40192690,25609159,65801849,6,0,0,512,17,1872533452
7469,40202280,34926544,75128824,9,0,1,1024,4,25817375
7470,40203090,25264988,65468078,7,0,0,31232,21,1151445689
7471,40206020,34922827,75128847,9,0,1,3584,4,8160184147
7472,40211050,25407628,65618678,7,0,0,47616,21,6083774478
7473,40225870,25352896,65578766,6,0,0,512,17,10193300360
7474,40238390,25380467,65618857,9,0,0,512,4,9016068752
7475,40246590,25646802,65893392,7,0,0,65024,21,2129492344
7476,40276840,34859541,75136381,2,0,1,10240,19,3905136956
7477,40282350,25176189,65458539,7,0,0,78336,21,4416535372
7478,40283240,24982117,65265357,1,0,0,1024,5,4634254651
7479,40300440,25417818,65718258,5,0,0,512,25,6741182885
7480,40302900,25101916,65404816,6,0,0,2560,17,9843855933
7481,40303960,25644443,65948403,1,0,0,61952,5,1730950051
7482,40305250,25224313,65529563,9,0,0,1536,4,9176322159
7483,40312141,25802777,66114918,2,0,0,17408,19,9268211847
7484,40316890,25173908,65490798,1,0,0,41984,5,4624616751
7485,40317390,25576337,65893727,1,0,0,1024,5,8392691334
7486,40317610,26424502,66742112,7,0,0,156160,21,380901505
7487,40323920,25044656,65368576,9,0,0,512,4,8581750283
7488,40327280,25251284,65578564,5,0,0,1024,25,9858324187
7489,40327650,34820825,75148475,0,0,1,5632,8,9055471011
7490,40348490,25295115,65643605,1,0,0,7680,5,1510700473
7491,40355980,25224890,65580870,6,0,0,512,17,4976932067
7492,40356640,25397666,65754306,7,0,0,23040,21,6757561584
7493,40356790,26664410,67021200,7,0,0,199680,21,7377851289
7494,40363990,25805765,66169755,7,0,0,152064,21,5152100308
7495,40373500,25591017,65964517,5,0,0,512,25,7836156888
7496,40375530,25216716,65592246,9,0,0,2560,4,8102472935
7497,40380960,25397500,65778460,7,0,0,9216,21,1390761070
7498,40382610,34770211,75152821,4,0,1,10240,25,9075212126
7499,40382891,25533867,65916758,2,0,0,10752,19,2148416407
7500,40388230,25412496,65800726,6,0,0,512,17,593705066
7501,40391790,25513944,65905734,5,0,0,3584,25,7445378226
7502,40396830,34787744,75184574,4,0,1,1536,25,4122463666
7503,40403630,25125442,65529072,1,0,0,33280,5,3710161909
7504,40413680,25320890,65734570,6,0,0,1024,17,724549191
7505,40413740,25646278,66060018,5,0,0,3584,25,1394139894
7506,40416170,25314580,65730750,0,0,0,11264,8,5984964318
7507,40419290,34765307,75184597,0,0,1,1024,8,2099590363
7508,40443250,25600594,66043844,7,0,0,48640,21,2149390147
7509,40445800,25138142,65583942,6,0,0,512,17,7196258028
7510,40448431,26593164,67041595,2,0,0,33280,19,911578246
7511,40448750,25042383,65491133,5,0,0,1024,25,10495749419
7512,40448931,26331261,66780192,2,0,0,16384,19,7691550660
7513,40457771,25733503,66191274,2,0,0,24576,19,2301107173
7514,40457841,25369083,65826924,2,0,0,8192,19,1072351152
7515,40463570,34724019,75187589,0,0,1,4608,8,4900051492
7516,40474830,25128417,65603247,5,0,0,1536,25,7775902343
7517,40485600,34703615,75189215,4,0,1,2560,25,9978164891
7518,40493320,26903658,67396978,1,0,0,20992,5,3046213021
7519,40494930,25549318,66044248,9,0,0,512,4,9808781597
7520,40499480,25616108,66115588,6,0,0,1024,17,3647799010
7521,40505830,27080274,67586104,1,0,0,3072,5,1094605995
7522,40506340,26005734,66512074,1,0,0,40960,5,8867232269
7523,40507130,26647435,67154565,7,0,0,15872,21,3097347463
7524,40513111,34676668,75189779,7,0,1,10752,21,6240355444
7525,40514570,34713078,75227648,9,0,1,4096,4,3326988581
7526,40527920,34703674,75231594,4,0,1,3584,25,6555350411
7527,40529280,34702337,75231617,0,0,1,512,8,4267942709
7528,40534650,25448373,65983023,9,0,0,512,4,9773305804
7529,40536560,26216454,66753014,7,0,0,19456,21,9586480661
7530,40536611,25293924,65830535,2,0,0,11776,19,1164101629
7531,40548370,25643932,66192302,6,0,0,2048,17,10145305350
7532,40554520,34677128,75231648,4,0,1,4608,25,7353655113
7533,40556250,34675429,75231679,0,0,1,3584,8,1109142423
7534,40579200,25536053,66115253,5,0,0,1024,25,995103972
7535,40581100,25610555,66191655,5,0,0,512,25,2051518658
7536,40584930,34646772,75231702,0,0,1,1536,8,8308136733
7537,40595720,25377052,65972772,1,0,0,10752,5,7374467744
7538,40609600,25354738,65964338,7,0,0,52224,21,9547701045
7539,40613290,25280662,65893952,9,0,0,512,4,7813514338
7540,40624380,26524400,67148780,9,0,0,512,4,424441027
7541,40625369,34606585,75231954,3,0,1,2560,21,4637875240
7542,40627391,26332946,66960337,2,0,0,49664,19,4722036428
7543,40628460,25142364,65770824,6,0,0,512,17,6809677541
7544,40630299,25465614,66095913,4,0,0,512,25,4077815065
7545,40646239,25207551,65853790,4,0,0,1536,25,6825748681
7546,40647420,25269517,65916937,5,0,0,512,25,675889029
7547,40651600,25531150,66182750,1,0,0,42496,5,6163406477
7548,40656310,25728667,66384977,5,0,0,512,25,5812013795
7549,40658090,26141682,66799772,5,0,0,512,25,215581195
7550,40658450,25577920,66236370,1,0,0,35840,5,2605424486
7551,40659020,25385049,66044069,5,0,0,512,25,421966641
7552,40661430,26012270,66673700,9,0,0,512,4,1950042636
7553,40666150,25165367,65831517,9,0,0,3072,4,5991172962
7554,40666240,34566060,75232300,3,0,1,512,21,10436320308
7555,40669520,25430692,66100212,9,0,0,512,4,6929767456
7556,40687889,26724183,67412072,4,0,0,512,25,2238382558
7557,40696670,25323637,66020307,1,0,0,512,5,3971471883
7558,40700061,25510015,66210076,2,0,0,8192,19,7154054669
7559,40704510,25513196,66217706,6,0,0,3072,17,10606958797
7560,40726419,25061160,65787579,4,0,0,512,25,95918154
7561,40733430,34504319,75237749,2,0,1,7168,19,2901943257
7562,40753250,34486765,75240015,2,0,1,3584,19,5772027914
7563,40756760,25143578,65900338,6,0,0,2560,17,7705749859
7564,40757320,34485052,75242372,2,0,1,3072,19,10252416729
7565,40763860,25259519,66023379,9,0,0,512,4,9315603208
7566,40763951,25479618,66243569,2,0,0,23552,19,8195770415
7567,40785650,34458988,75244638,2,0,1,3584,19,3822995653
7568,40786640,34459944,75246584,2,0,1,3072,19,757140887
7569,40789470,34457460,75246930,2,0,1,512,19,2166118975
7570,40796239,34453213,75249452,1,0,1,12800,5,10728735124
7571,40798550,34463503,75262053,2,0,1,4608,19,10078896415
7572,40809620,34479087,75288707,0,0,1,11264,8,3494899028
7573,40824570,25152386,65976956,5,0,0,512,25,7226649737
7574,40826650,25419282,66245932,1,0,0,7680,5,1476263766
7575,40831989,34457384,75289373,1,0,1,1024,5,10418903077
7576,40836831,25478201,66315032,2,0,0,49152,19,6008418006
7577,40837070,25346327,66183397,1,0,0,2048,5,7826208926
7578,40853900,25206688,66060588,6,0,0,1536,17,3972419625
7579,40855179,34435180,75290359,1,0,1,1536,5,2160870394
7580,40855321,34460678,75315999,7,0,1,40448,21,9044407560
7581,40857660,25560523,66418183,7,0,0,36352,21,7859042344
7582,40858381,34603371,75461752,7,0,1,79360,21,885286531
7583,40861720,26827059,67688779,1,0,0,53248,5,7676394306
7584,40863140,34640928,75504068,0,0,1,3072,8,3572660588
7585,40870140,26648164,67518304,7,0,0,74240,21,8373314775
7586,40873579,25488725,66362304,4,0,0,1024,25,2653886542
7587,40875559,25315917,66191476,4,0,0,512,25,3078593202
7588,40890200,25463067,66353267,5,0,0,512,25,1011911277
7589,40913520,26775774,67689294,5,0,0,1536,25,6523671467
7590,40914390,25457181,66371571,9,0,0,512,4,3329581263
7591,40914909,25160202,66075111,4,0,0,2560,25,3932026478
7592,40924539,26117235,67041774,4,0,0,512,25,8319002756
7593,40932750,25251005,66183755,5,0,0,1024,25,5931178401
7594,40932769,25506768,66439537,4,0,0,512,25,5579235550
7595,40935120,25449678,66384798,1,0,0,21504,5,6074913221
7596,40936410,25860599,66797009,1,0,0,37888,5,2554094099
7597,40937089,34602269,75539358,8,0,1,10240,1,2521254283
7598,40939400,26158869,67098269,1,0,0,185344,5,8158573867
7599,40949441,34805277,75754718,7,0,1,23040,21,7320815126
7600,40952561,35292433,76244994,7,0,1,79360,21,6064096840
7601,40954451,25972791,66927242,2,0,0,54784,19,2781175548
7602,40954630,35290387,76245017,0,0,1,2560,8,1720093357
7603,40955200,35345156,76300356,0,0,1,18432,8,1300391849
7604,40957760,26255636,67213396,7,0,0,44032,21,1405368272
7605,40963900,35338459,76302359,0,0,1,17408,8,2054807256
7606,40966490,35345945,76312435,0,0,1,1024,8,3401461792
7607,40972249,35340209,76312458,8,0,1,1536,1,7453805089
7608,40973141,25543151,66516292,2,0,0,12288,19,9367724070
7609,40974739,25933932,66908671,4,0,0,25600,25,9985400363
7610,40982940,35329541,76312481,2,0,1,5120,19,473857657
7611,40989581,35352742,76342323,7,0,1,7168,21,9562279519
7612,40993591,35454751,76448342,7,0,1,114176,21,3045182257
7613,41000760,25752612,66753372,5,0,0,512,25,8840577056
7614,41005130,25686528,66691658,7,0,0,10240,21,7122866635
7615,41015720,25731141,66746861,1,0,0,15360,5,10179185217
7616,41019910,35492320,76512230,0,0,1,1024,8,118373627
7617,41024760,26006493,67031253,6,0,0,2048,17,1431239724
7618,41026190,25909522,66935712,1,0,0,27648,5,2995747003
7619,41042080,25631441,66673521,1,0,0,191488,5,7409065320
7620,41044530,35467723,76512253,0,0,1,1024,8,1564705812
7621,41052541,35779021,76831562,7,0,1,148992,21,7858957989
7622,41054600,25813974,66868574,6,0,0,512,17,6576863822
7623,41055210,25268566,66323776,9,0,0,1024,4,2587923982
7624,41058360,25268488,66326848,9,0,0,1024,4,1478927127
7625,41065540,35770528,76836068,0,0,1,7168,8,2686621446
7626,41068500,26080101,67148601,1,0,0,129024,5,8910841731
7627,41069760,35778646,76848406,2,0,1,512,19,10382734956
7628,41073120,35780983,76854103,3,0,1,18944,21,5299452457
7629,41076809,25276279,66353088,4,0,0,14336,25,7249750430
7630,41080920,35791966,76872886,2,0,1,9216,19,4183037113
7631,41084440,25370892,66455332,5,0,0,2048,25,3097635084
7632,41087370,25300716,66388086,6,0,0,2048,17,3990565614
7633,41091470,26066643,67158113,1,0,0,11264,5,5002625648
7634,41094881,36079366,77174247,7,0,1,122880,21,3939323525
7635,41094970,36110670,77205640,2,0,1,512,19,1284261592
7636,41109231,25474610,66583841,2,0,0,15360,19,10416055395
7637,41109719,25790950,66900669,4,0,0,48640,25,5932115123
7638,41116589,25653249,66769838,4,0,0,9728,25,7394910177
7639,41120929,36084734,77205663,3,0,1,6656,21,357115544
7640,41127471,36444054,77571525,7,0,1,141312,21,6501214021
7641,41128280,25330597,66458877,6,0,0,512,17,4369927934
7642,41129040,25746981,66876021,9,0,0,1536,4,359692919
7643,41133550,25325052,66458602,6,0,0,512,17,9488053807
7644,41134979,36509751,77644730,3,0,1,2048,21,3570564086
7645,41136370,26129346,67265716,1,0,0,31744,5,7538443544
7646,41136860,26177660,67314520,7,0,0,40960,21,628158322
7647,41139850,36504903,77644753,2,0,1,2048,19,739947109
7648,41142220,36502556,77644776,2,0,1,11264,19,6175713276
7649,41142939,36501860,77644799,3,0,1,2048,21,8958775260
7650,41146050,25754798,66900848,5,0,0,512,25,8291709247
7651,41149251,26521051,67670302,2,0,0,183808,19,8326664226
7652,41151210,25453337,66604547,6,0,0,1536,17,905262470
7653,41154470,36490352,77644822,2,0,1,1536,19,2882865430
7654,41155280,36489565,77644845,2,0,1,3584,19,5340302026
7655,41159000,26612953,67771953,1,0,0,18432,5,8967704755
7656,41163020,25584043,66747063,5,0,0,512,25,8483474817
7657,41167219,36477649,77644868,3,0,1,7168,21,9003324044
7658,41167669,36477222,77644891,3,0,1,6144,21,1213926686
7659,41170140,25583053,66753193,5,0,0,512,25,10428696614
7660,41177071,36467843,77644914,7,0,1,16896,21,7184075888
7661,41179110,36512219,77691329,2,0,1,1024,19,2074532781
7662,41181699,36556842,77738541,3,0,1,10752,21,7946926361
7663,41185891,26350220,67536111,2,0,0,58368,19,8356725470
7664,41193860,25827519,67021379,5,0,0,512,25,7637645662
7665,41202479,36536085,77738564,3,0,1,512,21,2502229549
7666,41204520,26799157,68003677,7,0,0,37376,21,1631517873
7667,41205740,36532847,77738587,4,0,1,11264,25,324177077
7668,41211580,36527030,77738610,0,0,1,3072,8,9415844967
7669,41212621,25817985,67030606,2,0,0,30208,19,6329725442
7670,41217000,25580344,66797344,6,0,0,1024,17,4306460709
7671,41217479,36521162,77738641,3,0,1,2048,21,2611444290
7672,41218060,26709450,67927510,1,0,0,81920,5,605425855
7673,41221610,25576626,66798236,6,0,0,512,17,2266051858
7674,41226870,26358275,67585145,9,0,0,2048,4,8766983897
7675,41230621,36523229,77753850,7,0,1,20480,21,8735082176
7676,41230971,36575059,77806030,7,0,1,50176,21,3023201597
7677,41235029,36611775,77846804,3,0,1,512,21,4239774188
7678,41237949,26468502,67706451,4,0,0,44032,25,3007603656
7679,41249761,36650599,77900360,7,0,1,41472,21,9075642900
7680,41250180,26608913,67859093,5,0,0,512,25,8747738306
7681,41251160,25848076,67099236,9,0,0,3072,4,5688889728
7682,41251269,36649255,77900524,3,0,1,7168,21,10665902114
7683,41253610,36654208,77907818,2,0,1,3072,19,10595325357
7684,41257090,25938450,67195540,1,0,0,28672,5,7954953376
7685,41264279,25919807,67184086,4,0,0,57344,25,8918910764
7686,41281150,26186118,67467268,9,0,0,2560,4,4077512076
7687,41286200,25745232,67031432,9,0,0,512,4,7925340923
7688,41291840,25817426,67109266,9,0,0,1536,4,6561082378
7689,41297869,36614775,77912644,3,0,1,7680,21,9724007644
7690,41300870,36619445,77920315,2,0,1,3584,19,2007785382
7691,41303220,25805555,67108775,0,0,0,31232,8,1905559958
7692,41303381,37067178,78370559,7,0,1,147968,21,5740180268
7693,41310080,37080516,78390596,2,0,1,512,19,7698178032
7694,41312920,37079302,78392222,2,0,1,2560,19,5114057588
7695,41318660,26095931,67414591,1,0,0,8192,5,4686421623
7696,41320320,26230844,67551164,1,0,0,22016,5,8213178194
7697,41328440,26060595,67389035,7,0,0,27136,21,9493824481
7698,41343199,37050329,78393528,3,0,1,2048,21,6998652598
7699,41344399,37049795,78394194,3,0,1,1024,21,9158513273
7700,41345890,25803747,67149637,7,0,0,2560,21,1926361345
7701,41346069,25872855,67218924,4,0,0,2560,25,9524964915
7702,41349870,26024677,67374547,7,0,0,22016,21,1616170025
7703,41356040,37049413,78405453,4,0,1,5632,25,6216032080
7704,41357740,26762128,68119868,7,0,0,164352,21,5023432299
7705,41358050,37096745,78454795,2,0,1,4096,19,4864611085
7706,41388319,26023574,67411893,4,0,0,34816,25,305477543
7707,41393250,25823981,67217231,5,0,0,1024,25,8870089310
7708,41397361,26051733,67449094,2,0,0,30720,19,194805137
7709,41399140,26744727,68143867,6,0,0,1536,17,7337167786
7710,41402459,26922955,68325414,4,0,0,96256,25,9446570042
7711,41421550,25792181,67213731,5,0,0,1024,25,6524222113
7712,41430960,25943922,67374882,5,0,0,1024,25,8477280544
7713,41431821,25889617,67321438,2,0,0,16896,19,7700237133
7714,41432160,26293521,67725681,1,0,0,7680,5,988537985
7715,41439540,25835538,67275078,5,0,0,512,25,5293995155
7716,41445610,37012062,78457672,9,0,1,1024,4,8607808148
7717,41448400,37009295,78457695,4,0,1,9728,25,9721988905
7718,41451010,26716193,68167203,9,0,0,1536,4,5439873738
7719,41453550,26951700,68405250,7,0,0,110080,21,2147598604
7720,41458081,26002745,67460826,2,0,0,29696,19,7701532023
7721,41462000,26244942,67706942,6,0,0,1536,17,10531780761
7722,41472610,36985108,78457718,4,0,1,1536,25,6714978562
7723,41479230,25987235,67466465,7,0,0,18432,21,7406799396
7724,41479480,36978261,78457741,4,0,1,4096,25,6678770657
7725,41482240,26061702,67543942,1,0,0,25600,5,284583542
7726,41484099,26299756,67783855,4,0,0,5632,25,139771628
7727,41488770,26713587,68202357,7,0,0,4096,21,400752805
7728,41489980,36967963,78457943,9,0,1,4608,4,5827777887
7729,41493929,36964037,78457966,3,0,1,2560,21,4555653429
7730,41495050,25796134,67291184,6,0,0,512,17,597622299
7731,41495910,36966584,78462494,9,0,1,17408,4,1841588547
7732,41500360,25948913,67449273,6,0,0,512,17,10111407607
7733,41503031,26472856,67975887,2,0,0,49152,19,9375135620
7734,41504011,26080487,67584498,2,0,0,60416,19,1835981805
7735,41515480,36952160,78467640,9,0,1,8192,4,5515253955
7736,41522550,26408103,67930653,1,0,0,10240,5,9158277601
7737,41537550,36931396,78468946,9,0,1,2048,4,7059651563
7738,41539430,36930822,78470252,4,0,1,2048,25,6212753425
7739,41544280,36930478,78474758,9,0,1,7168,4,5017427996
7740,41554060,25846502,67400562,6,0,0,512,17,1520825711
7741,41555880,26162271,67718151,5,0,0,512,25,3711729925
7742,41556700,25987733,67544433,5,0,0,1536,25,5692166404
7743,41561201,37051131,78612332,5,0,1,69120,25,9882872139
7744,41569491,26596574,68166065,2,0,0,65536,19,3154461958
7745,41571770,26098711,67670481,6,0,0,512,17,8420514303
7746,41595440,37017251,78612691,4,0,1,9728,25,1823682178
7747,41598270,37046757,78645027,4,0,1,512,25,8243965275
7748,41598480,26221021,67819501,6,0,0,1024,17,3307143447
7749,41599510,26184532,67784042,9,0,0,512,4,8929025006
7750,41600840,37044341,78645181,9,0,1,8704,4,3993065083
7751,41608830,26335247,67944077,6,0,0,1024,17,4034495997
7752,41614181,26426638,68040819,2,0,0,43008,19,1067765175
7753,41619310,26087811,67707121,5,0,0,512,25,5549164331
7754,41621621,26520624,68142245,2,0,0,41472,19,10232333396
7755,41628701,26180236,67808937,2,0,0,44032,19,7403635882
7756,41631090,37053505,78684595,4,0,1,2560,25,1384424121
7757,41634101,37225143,78859244,7,0,1,34816,21,4113062307
7758,41635121,37236517,78871638,5,0,1,36864,25,9419157905
7759,41638660,37236924,78875584,9,0,1,4608,4,1904844245
7760,41652020,25934575,67586595,9,0,0,1536,4,6768806310
7761,41657359,26471892,68129251,4,0,0,30720,25,10730925803
7762,41664120,26117996,67782116,7,0,0,33280,21,8003364166
7763,41666721,37523163,79189884,5,0,1,79360,25,8915960726
7764,41667789,26618824,68286613,4,0,0,20480,25,10566346194
7765,41675170,37565780,79240950,9,0,1,20480,4,8224223582
7766,41677179,26466181,68143360,4,0,0,3584,25,10523913432
7767,41677410,37563886,79241296,9,0,1,512,4,7672213483
7768,41683880,37558082,79241962,9,0,1,1024,4,4234760714
7769,41684629,26919005,68603634,4,0,0,59392,25,6479304606
7770,41685770,25986762,67672532,1,0,0,6656,5,6442857995
7771,41687570,26379698,68067268,6,0,0,1024,17,2333945378
7772,41687620,37588055,79275675,4,0,1,13824,25,5914773706
7773,41688720,37588261,79276981,9,0,1,2048,4,5960202619
7774,41700770,37619554,79320324,4,0,1,512,25,4238655230
7775,41710020,26006595,67716615,5,0,0,512,25,593429265
7776,41711719,26162865,67874584,4,0,0,48640,25,2829358087
7777,41711880,37615822,79327702,9,0,1,4608,4,233879059
7778,41722839,26528723,68251562,4,0,0,12800,25,9443411047
7779,41733341,37594384,79327725,5,0,1,6144,25,1459972618
7780,41735260,37592488,79327748,9,0,1,6144,4,7646988049
7781,41740861,37586910,79327771,5,0,1,2048,25,3421327176
7782,41742980,37584814,79327794,9,0,1,8704,4,4333066344
7783,41747380,37581084,79328464,4,0,1,1536,25,2420186415
7784,41748090,26476800,68224890,5,0,0,512,25,8247805231
7785,41750350,26180646,67930996,6,0,0,1024,17,5186348188
7786,41751439,26473272,68224711,4,0,0,73216,25,1890524695
7787,41757030,37611439,79368469,4,0,1,512,25,8353690198
7788,41761870,26248971,68010841,9,0,0,1536,4,606674494
7789,41765790,37602702,79368492,9,0,1,512,4,8122827595
7790,41785121,26415957,68201078,2,0,0,111104,19,3639133882
7791,41790050,26091767,67881817,9,0,0,512,4,5230267984
7792,41797730,26436947,68234677,6,0,0,512,17,1504878623
7793,41798241,26060673,67858914,2,0,0,5632,19,5701149125
7794,41806680,26216414,68023094,5,0,0,2560,25,4198929222
7795,41808140,26196028,68004168,9,0,0,1536,4,2602249932
7796,41810010,26441731,68251741,9,0,0,512,4,2048662150
7797,41811430,26233491,68044921,9,0,0,1536,4,10518227947
7798,41817261,37584302,79401563,5,0,1,29696,25,8490832232
7799,41823820,26220610,68044430,7,0,0,11776,21,3397498413
7800,41824769,26422793,68247562,4,0,0,41984,25,1650540509
7801,41830800,37600480,79431280,4,0,1,11264,25,2823714902
7802,41833720,26170627,68004347,5,0,0,512,25,7390619245
7803,41841960,26179304,68021264,9,0,0,2048,4,5313675699
7804,41851310,26585245,68436555,9,0,0,512,4,5243954221
7805,41851900,26519452,68371352,1,0,0,20480,5,4414934526
7806,41852231,37719325,79571556,5,0,1,67584,25,3979181405
7807,41857991,37714871,79572862,5,0,1,2048,25,4241338226
7808,41869299,37731933,79601232,3,0,1,10240,21,5595415622
7809,41869509,26106557,67976066,4,0,0,512,25,4297839433
7810,41876251,26452150,68328401,2,0,0,9728,19,4496639891
7811,41879900,26813812,68693712,9,0,0,1024,4,5334378164
7812,41880441,38076474,79956915,5,0,1,154624,25,10055007886
7813,41893790,26688818,68582608,7,0,0,2560,21,10035780397
7814,41902951,38087981,79990932,5,0,1,31232,25,8389856679
7815,41904740,38162346,80067086,4,0,1,59392,25,489946659
7816,41906330,38160779,80067109,0,0,1,2560,8,8711827966
7817,41911710,26752672,68664382,1,0,0,73216,5,9088022937
7818,41915290,26214296,68129586,9,0,0,1024,4,5653485692
7819,41926060,26746024,68672084,6,0,0,512,17,5293280789
7820,41932260,26480969,68413229,1,0,0,26112,5,7838139213
7821,41935860,26769568,68705428,9,0,0,1024,4,7059699425
7822,41936951,26209123,68146074,2,0,0,7168,19,3800185998
7823,41944520,26844437,68788957,1,0,0,129024,5,8120076557
7824,41951781,38164419,80116200,5,0,1,36864,25,2684719635
7825,41953589,26274132,68227721,4,0,0,9216,25,1532993978
7826,41957081,26277417,68234498,2,0,0,22016,19,7742305623
7827,41972010,26998658,68970668,7,0,0,143360,21,975197479
7828,41978060,38148527,80126587,4,0,1,20992,25,3275614366
7829,41982450,26184262,68166712,9,0,0,2048,4,3398524114
7830,41986831,38237603,80224434,5,0,1,77312,25,4520383914
7831,42001840,38554970,80556810,4,0,1,165888,25,5359649432
7832,42003640,26856934,68860574,6,0,0,3584,17,3116515674
7833,42005061,38613670,80618731,5,0,1,10240,25,10371234592
7834,42006030,38680184,80686214,4,0,1,48128,25,5591429638
7835,42017361,26816726,68834087,2,0,0,68608,19,6711965449
7836,42019130,26321083,68340213,1,0,0,11776,5,8251871479
7837,42024150,26579663,68603813,5,0,0,512,25,868698985
7838,42028350,26711749,68740099,6,0,0,512,17,820884326
7839,42028480,27068642,69097122,9,0,0,512,4,7236587691
7840,42028530,26582799,68611329,7,0,0,18944,21,3817657715
7841,42029110,38672774,80701884,4,0,1,33280,25,8951635996
7842,42029279,26710641,68739920,4,0,0,62976,25,4071363672
7843,42029340,26552334,68581674,5,0,0,512,25,2055149515
7844,42031560,26381848,68413408,9,0,0,512,4,3677692446
7845,42032910,26398672,68431582,9,0,0,2048,4,177083672
7846,42039849,26773311,68813160,4,0,0,79360,25,4677066418
7847,42042039,38660511,80702550,8,0,1,1024,1,3855560383
7848,42042660,26834824,68877484,1,0,0,33792,5,416541291
7849,42043019,38672519,80715538,8,0,1,3072,1,4450486208
7850,42046881,38689094,80735975,5,0,1,27648,25,8661706883
7851,42046970,38813684,80860654,4,0,1,42496,25,5637528111
7852,42047900,27110119,69158019,1,0,0,181248,5,10007033498
7853,42050590,26321097,68371687,6,0,0,1024,17,1288455432
7854,42051750,26807709,68859459,1,0,0,73728,5,10486446165
7855,42055760,26931155,68986915,7,0,0,53248,21,9703215762
7856,42061100,26356190,68417290,9,0,0,512,4,5594882309
7857,42069950,26439139,68509089,5,0,0,512,25,4249744163
7858,42070051,39031657,81101708,5,0,1,116736,25,2938732864
7859,42072490,26805173,68877663,5,0,0,512,25,9712491512
7860,42079231,26757375,68836606,2,0,0,8192,19,5507321951
7861,42084070,26752894,68836964,5,0,0,512,25,2211023618
7862,42087079,26924218,69011297,4,0,0,78848,25,9813177112
7863,42088461,26778704,68867165,2,0,0,21504,19,6554643201
7864,42096600,26890650,68987250,6,0,0,1024,17,9102223230
7865,42099370,27071175,69170545,1,0,0,40960,5,3628474787
7866,42113360,26902459,69015819,7,0,0,7680,21,10415775967
7867,42125710,38999853,81125563,4,0,1,51712,25,6589168532
7868,42130501,26966419,69096920,2,0,0,23040,19,971218097
7869,42130750,27082385,69213135,9,0,0,512,4,10042475188
7870,42133950,39134633,81268583,4,0,1,91648,25,6626551345
7871,42135190,27243591,69378781,7,0,0,115200,21,1120787842
7872,42138080,39155019,81293099,4,0,1,89600,25,4434185244
7873,42139270,26697515,68836785,9,0,0,512,4,3398932821
7874,42141000,39154685,81295685,4,0,1,4096,25,3292377162
7875,42143011,39153020,81296031,5,0,1,512,25,9612625130
7876,42149659,39148936,81298595,8,0,1,512,1,5499525249
7877,42152389,39147832,81300221,8,0,1,2560,1,4205102895
7878,42156260,26873326,69029586,7,0,0,45056,21,4707594412
7879,42160730,39143842,81304572,4,0,1,4096,25,10578347476
7880,42162600,26850825,69013425,1,0,0,6144,5,5338724891
7881,42167180,27176478,69343658,7,0,0,73728,21,2219223486
7882,42176570,39147569,81324139,4,0,1,48128,25,6226121293
7883,42180940,39144185,81325125,4,0,1,1536,25,5825843592
7884,42191920,39133551,81325471,9,0,1,512,4,10567051784
7885,42193739,27019217,69212956,4,0,0,105984,25,1946657510
7886,42196910,39129867,81326777,4,0,1,2048,25,10286423376
7887,42199700,26885288,69084988,9,0,0,512,4,8248306242
7888,42202819,39126783,81329602,8,0,1,2560,1,2118441803
7889,42205330,26806169,69011499,7,0,0,512,21,631962780
7890,42210931,39161254,81372185,5,0,1,65536,25,5769492887
7891,42218220,27267499,69485719,7,0,0,116224,21,4353081221
7892,42222870,26952222,69175092,7,0,0,14848,21,5603901239
7893,42231529,27273493,69505022,4,0,0,62976,25,7744422744
7894,42234900,26940683,69175583,5,0,0,1536,25,375045995
7895,42248839,27142921,69391760,4,0,0,42496,25,9869286636
7896,42249160,39128856,81378016,4,0,1,4608,25,10015869778
7897,42249510,27256159,69505669,6,0,0,2048,17,5683361730
7898,42259349,39119128,81378477,8,0,1,10240,1,9955124291
7899,42260770,26962225,69222995,9,0,0,512,4,3796965120
7900,42261640,27188644,69450284,7,0,0,73216,21,8742259491
7901,42273470,27297960,69571430,1,0,0,79872,5,3520381507
7902,42273970,39108693,81382663,4,0,1,6656,25,8041998574
7903,42282960,39100049,81383009,9,0,1,512,4,8014186952
7904,42288690,39094473,81383163,4,0,1,8704,25,4906679035
7905,42299080,27020780,69319860,9,0,0,1536,4,3772868204
7906,42302279,26911503,69213782,4,0,0,2048,25,5574381748
7907,42307831,39089213,81397044,5,0,1,14336,25,10176020189
7908,42309000,39096185,81405185,2,0,1,1536,19,3505581567
7909,42315411,27076684,69392095,2,0,0,1024,19,6818181837
7910,42316530,27004554,69321084,5,0,0,512,25,4727159134
7911,42316670,39089181,81405851,4,0,1,1024,25,1887651442
7912,42323490,26965344,69288834,6,0,0,2560,17,1806655003
7913,42333459,39072546,81406005,8,0,1,8704,1,5981523415
7914,42345911,27048422,69394333,2,0,0,7168,19,4398867681
7915,42348461,27159282,69507743,2,0,0,4096,19,5136842133
7916,42348589,39057762,81406351,8,0,1,512,1,6437021272
7917,42352160,27239581,69591741,1,0,0,3072,5,4684278491
7918,42353390,39056507,81409897,4,0,1,5632,25,8229806209
7919,42366360,39048165,81414525,4,0,1,5632,25,3441300688
7920,42367619,39049172,81416791,8,0,1,3584,1,5201822494
7921,42374650,27034268,69408918,6,0,0,512,17,725427709
7922,42380900,27125572,69506472,9,0,0,2560,4,2235952250
7923,42384919,39032858,81417777,8,0,1,1536,1,1423934953
7924,42391640,27116398,69508038,9,0,0,512,4,817248863
7925,42393820,39024303,81418123,4,0,1,512,25,7784440439
7926,42400910,39018839,81419749,4,0,1,2560,25,25318786
7927,42426239,38995456,81421695,8,0,1,3072,1,188123981
7928,42427421,27313432,69740853,2,0,0,103424,19,4862480270
7929,42429380,38996821,81426201,4,0,1,19456,25,10445380479
7930,42434749,39004018,81438767,8,0,1,8192,1,3517204041
7931,42439380,39026032,81465412,4,0,1,9728,25,2052663808
7932,42439981,27141904,69581885,2,0,0,29184,19,2989601388
7933,42443650,27311982,69755632,1,0,0,6656,5,4423179407
7934,42447139,39022459,81469598,8,0,1,6656,1,2725907919
7935,42462220,39011564,81473784,4,0,1,6656,25,4098901131
7936,42462640,27157527,69620167,7,0,0,30720,21,2781655552
7937,42463790,27289722,69753512,7,0,0,41472,21,9201280854
7938,42463870,27194868,69658738,9,0,0,512,4,9453410880
7939,42473211,39017080,81490291,5,0,1,44032,25,10267590099
7940,42474781,39118508,81593289,5,0,1,78336,25,8528920868
7941,42474810,39121705,81596515,4,0,1,5120,25,2973844032
7942,42477500,27224689,69702189,1,0,0,2560,5,7764260110
7943,42479110,39118391,81597501,4,0,1,1536,25,2723944740
7944,42481761,39586827,82068588,5,0,1,212480,25,970249215
7945,42482051,27380253,69862304,2,0,0,4608,19,4061591817
7946,42485580,39603380,82088960,4,0,1,13824,25,3256165627
7947,42487640,39601359,82088999,9,0,1,9728,4,4876742012
7948,42492570,39600843,82093413,4,0,1,19456,25,9787530038
7949,42492710,27417319,69910029,1,0,0,137728,5,3610570497
7950,42495771,39610995,82106766,5,0,1,2048,25,8085597095
7951,42497210,39609587,82106797,4,0,1,6656,25,9344385668
7952,42497250,39609570,82106820,4,0,1,1536,25,3417262498
7953,42515239,39593477,82108716,8,0,1,3072,1,635687645
7954,42526321,39591087,82117408,5,0,1,13824,25,7384474447
7955,42534310,27442541,69976851,5,0,0,512,25,86977009
7956,42539740,27490247,70029987,7,0,0,49152,21,3743338136
7957,42541309,39579325,82120634,8,0,1,5120,1,6579290431
7958,42544821,39619792,82164613,5,0,1,33792,25,8554895832
7959,42553120,39611516,82164636,4,0,1,2048,25,7088597231
7960,42558700,27352293,69910993,9,0,0,1024,4,4723992954
7961,42563710,39609356,82173066,4,0,1,14848,25,5609623953
7962,42566880,27407879,69974759,6,0,0,1536,17,231669082
7963,42570571,39646339,82216910,5,0,1,28672,25,6192051214
7964,42573190,27337353,69910543,9,0,0,1536,4,1502557764
7965,42576359,39640574,82216933,8,0,1,2560,1,6516595950
7966,42581401,39635555,82216956,5,0,1,6656,25,10163126702
7967,42584090,27337296,69921386,6,0,0,512,17,77612449
7968,42589681,39718031,82307712,7,0,1,90112,21,4525030467
7969,42591390,39728257,82319647,4,0,1,5120,25,7066112456
7970,42595480,27496725,70092205,5,0,0,3072,25,10695181134
7971,42602001,27753988,70355989,2,0,0,13312,19,6514004587
7972,42602121,39809988,82412109,5,0,1,57856,25,8597100057
7973,42602650,27607679,70210329,1,0,0,41472,5,9805854140
7974,42602680,39809452,82412132,4,0,1,3584,25,1735887780
7975,42603370,39810836,82414206,4,0,1,18944,25,5700224388
7976,42607310,27692741,70300051,1,0,0,7680,5,6696654212
7977,42610111,39836464,82446575,5,0,1,41472,25,8506815333
7978,42616060,39835839,82451899,4,0,1,512,25,7684782576
7979,42621800,39833325,82455125,4,0,1,5120,25,2872861828
7980,42624300,27673388,70297688,7,0,0,63488,21,1061305137
7981,42633500,27457746,70091246,7,0,0,19456,21,4234226948
7982,42634360,27338349,69972709,9,0,0,4096,4,4763986739
7983,42647120,27367138,70014258,9,0,0,2560,4,9219939948
7984,42651050,27670876,70321926,1,0,0,12800,5,115704473
7985,42656410,39803790,82460200,0,0,1,3072,8,2195451468
7986,42657020,27465443,70122463,5,0,0,2560,25,3542394288
7987,42662991,39806315,82469306,7,0,1,9728,21,9221012816
7988,42663020,39807592,82470612,0,0,1,2048,8,5761717712
7989,42671040,39801518,82472558,4,0,1,3072,25,5295331225
7990,42674371,39946099,82620470,5,0,1,105984,25,8895089737
7991,42681980,39962346,82644326,4,0,1,5632,25,9010967093
7992,42682289,27784193,70466482,4,0,0,23040,25,8974988075
7993,42687660,27509964,70197624,1,0,0,40448,5,10640442954
7994,42689990,27414837,70104827,6,0,0,512,17,9037239444
7995,42690780,39955812,82646592,4,0,1,3584,25,4496313590
7996,42695080,39957209,82652289,4,0,1,18944,25,750683512
7997,42700360,27455250,70155610,9,0,0,1024,4,10641502216
7998,42701619,39973564,82675183,8,0,1,2048,1,77818035
7999,42705589,39969617,82675206,3,0,1,3584,21,7120626639
8000,42706599,39970681,82677280,8,0,1,7168,1,194771908
8001,42707820,27632279,70340099,9,0,0,512,4,16510716
8002,42709380,39981541,82690921,0,0,1,1024,8,4693196036
8003,42710220,27320486,70030706,9,0,0,1536,4,10093476162
8004,42732520,27350556,70083076,9,0,0,1024,4,6835861250
8005,42736000,39955267,82691267,4,0,1,512,25,10153853385
8006,42738851,39961991,82700842,5,0,1,24064,25,4141397916
8007,42744431,39979601,82724032,5,0,1,15872,25,2165608966
8008,42749671,39981803,82731474,5,0,1,4608,25,6227627297
8009,42757510,27495832,70253342,9,0,0,512,4,882437906
8010,42757781,28071821,70829602,2,0,0,205824,19,7976314927
8011,42758380,27452228,70210608,9,0,0,512,4,185740582
8012,42759549,39971948,82731497,8,0,1,1024,1,9780081879
8013,42761809,39992435,82754244,8,0,1,11264,1,105873067
8014,42762171,39993353,82755524,5,0,1,14336,25,4939835457
8015,42765540,40009396,82774936,0,0,1,5120,8,2804568710
8016,42767420,27535618,70303038,1,0,0,9728,5,8795666915
8017,42770860,40004099,82774959,0,0,1,3584,8,9796551276
8018,42772690,27994177,70766867,1,0,0,53760,5,5938256180
8019,42779990,27606363,70386353,7,0,0,13312,21,6815060872
8020,42783151,27525742,70308893,2,0,0,12288,19,7498314157
8021,42785561,27908303,70693864,2,0,0,110592,19,3045321610
8022,42789810,27720808,70510618,7,0,0,3584,21,7944373958
8023,42791439,39983543,82774982,8,0,1,2560,1,4238863632
8024,42796291,40061601,82857892,5,0,1,41984,25,803763183
8025,42796650,40061265,82857915,0,0,1,11776,8,1564390436
8026,42798199,40086969,82885168,8,0,1,8704,1,8302971209
8027,42800120,40085071,82885191,0,0,1,5120,8,612816594
8028,42809341,40138106,82947447,5,0,1,83456,25,6296604277
8029,42819231,27439973,70259204,2,0,0,12800,19,8928015639
8030,42819930,27718942,70538872,9,0,0,512,4,551956993
8031,42825740,27541783,70367523,1,0,0,33280,5,7080865026
8032,42831620,27798074,70629694,1,0,0,13824,5,7374256701
8033,42836601,40258939,83095540,5,0,1,66560,25,5742704096
8034,42858140,27668246,70526386,7,0,0,31232,21,9072746505
8035,42865001,27966340,70831341,2,0,0,5632,19,5668715923
8036,42866570,27995150,70861720,1,0,0,39936,5,267644627
8037,42869550,40226451,83096001,0,0,1,10240,8,6816909480
8038,42874481,27623322,70497803,2,0,0,25088,19,9815919015
8039,42875560,27986651,70862211,6,0,0,1536,17,7747676240
8040,42877870,27699805,70577675,9,0,0,512,4,2170420060
8041,42883091,40241452,83124543,5,0,1,31744,25,9494205174
8042,42884740,27556039,70440779,5,0,0,1024,25,7353026289
8043,42889250,40296553,83185803,0,0,1,1536,8,10125800256
8044,42890290,28052728,70943018,7,0,0,36864,21,1381185147
8045,42892820,27481000,70373820,9,0,0,512,4,8190351757
8046,42898260,40297885,83196145,0,0,1,3584,8,10483924261
8047,42917331,40412065,83329396,5,0,1,104448,25,3812324503
8048,42919111,40534013,83453124,5,0,1,107520,25,1741667587
8049,42943860,40510250,83454110,9,0,1,1536,4,6011882886
8050,42949120,27696397,70645517,6,0,0,1024,17,1017802991
8051,42953830,40501586,83455416,9,0,1,2048,4,9511060645
8052,42953920,27775207,70729127,7,0,0,37376,21,3865749948
8053,42958900,40607751,83566651,4,0,1,24576,25,7546574126
8054,42965921,40600753,83566674,5,0,1,7680,25,1489389793
8055,42971650,27653809,70625459,1,0,0,22016,5,1960755943
8056,42972830,27506754,70479584,5,0,0,1024,25,2727733365
8057,42977050,40592790,83569840,4,0,1,10752,25,3298664047
8058,42978171,40775773,83753944,5,0,1,54272,25,6501970958
8059,42979710,40798444,83778154,9,0,1,10240,4,9877126282
8060,42985711,27946020,70931731,2,0,0,48640,19,5736070884
8061,42985870,40820754,83806624,0,0,1,5632,8,1100102157
8062,42987230,27469605,70456835,9,0,0,1536,4,6653567664
8063,42995020,27875769,70870789,7,0,0,10752,21,2980921303
8064,42995311,40811671,83806982,5,0,1,3072,25,6022265634
8065,42996670,40810335,83807005,9,0,1,6656,4,10291802538
8066,42997790,27552813,70550603,9,0,0,512,4,6638058316
8067,43005800,40801228,83807028,4,0,1,1024,25,1586443074
8068,43009340,27606896,70616236,1,0,0,22528,5,364798981
8069,43010211,40818071,83828282,5,0,1,67072,25,123959109
8070,43012910,40838922,83851832,0,0,1,512,8,5033184954
8071,43013070,27854179,70867249,7,0,0,16384,21,1403657917
8072,43014371,27901599,70915970,2,0,0,51712,19,5632746565
8073,43019260,40835478,83854738,0,0,1,4608,8,10704879380
8074,43020531,40840108,83860639,5,0,1,19968,25,895918480
8075,43038400,27829036,70867436,9,0,0,512,4,4114677125
8076,43046279,40869102,83915381,1,0,1,1536,5,7183829002
8077,43056291,27942191,70998482,2,0,0,19456,19,5532359971
8078,43057460,40857944,83915404,0,0,1,3072,8,3030566018
8079,43061360,28050699,71112059,7,0,0,1024,21,9993212394
8080,43063271,40854777,83918048,5,0,1,10240,25,9031693100
8081,43066590,28376119,71442709,1,0,0,57344,5,3444684234
8082,43074621,27767218,70841839,2,0,0,34304,19,8050941064
8083,43075700,27820540,70896240,5,0,0,1536,25,2776663977
8084,43078780,40839934,83918714,9,0,1,1024,4,7772463011
8085,43084741,28022629,71107370,2,0,0,7168,19,3767678363
8086,43086530,27762820,70849350,7,0,0,24576,21,8099583380
8087,43086651,40844621,83931272,5,0,1,25600,25,4478743718
8088,43105391,28040781,71146172,2,0,0,29184,19,10177578993
8089,43105440,27744089,70849529,6,0,0,512,17,6690612522
8090,43106710,40825023,83931733,0,0,1,10240,8,3841708365
8091,43109900,40826979,83936879,0,0,1,8192,8,2925169732
8092,43121800,40817985,83939785,0,0,1,4608,8,4620377303
8093,43123080,27793317,70916397,6,0,0,1024,17,8892107336
8094,43130070,27499826,70629896,9,0,0,512,4,10250623215
8095,43131400,27485795,70617195,6,0,0,3072,17,8821105184
8096,43131521,40924018,84055539,5,0,1,148480,25,7970459440
8097,43139200,28170735,71309935,9,0,0,512,4,10681215931
8098,43141670,28229333,71371003,9,0,0,512,4,10581057473
8099,43142550,40942891,84085441,0,0,1,2560,8,6980301447
8100,43143900,28131051,71274951,7,0,0,8704,21,6400352811
8101,43147660,40937804,84085464,4,0,1,8704,25,7384966379
8102,43149670,40944715,84094385,9,0,1,7680,4,2703989990
8103,43150380,27932945,71083325,1,0,0,33792,5,10356346029
8104,43155090,40939961,84095051,0,0,1,1024,8,9461495699
8105,43159490,27757398,70916888,6,0,0,1536,17,2145038424
8106,43163500,27873572,71037072,1,0,0,48128,5,1628047176
8107,43163850,40931867,84095717,0,0,1,1024,8,3458047697
8108,43198490,28285503,71483993,1,0,0,111616,5,6888498510
8109,43210930,28010315,71221245,9,0,0,512,4,1505674369
8110,43211140,40884923,84096063,4,0,1,512,25,2509873863
8111,43212861,40932893,84145754,5,0,1,80384,25,9334968975
8112,43216210,40930530,84146740,9,0,1,1536,4,4712568610
8113,43216680,40944937,84161617,4,0,1,10752,25,2344954103
8114,43222160,40951845,84174005,0,0,1,7680,8,508099076
8115,43222320,27866431,71088751,9,0,0,1024,4,7524130374
8116,43226230,40966243,84192473,9,0,1,8704,4,5995178295
8117,43226590,28080734,71307324,1,0,0,86528,5,8557584825
8118,43230030,27866252,71096282,6,0,0,1024,17,3527044765
8119,43234410,27879029,71113439,9,0,0,512,4,3216793320
8120,43241900,40955766,84197666,0,0,1,10240,8,8107323730
8121,43250300,27878677,71128977,9,0,0,1024,4,4415674799
8122,43253620,40945032,84198652,0,0,1,1536,8,812351369
8123,43261031,40938543,84199574,5,0,1,20480,25,5029340813
8124,43274670,40925775,84200445,0,0,1,12288,8,8447301305
8125,43283050,40935068,84218118,4,0,1,2048,25,4293408499
8126,43284760,40934344,84219104,4,0,1,1536,25,8722130606
8127,43286260,27886713,71172973,7,0,0,4096,21,1540068419
8128,43287560,28275467,71563027,6,0,0,512,17,9077344479
8129,43291231,27585307,70876538,2,0,0,8704,19,9452922982
8130,43298961,28247711,71546672,2,0,0,94208,19,891644151
8131,43302000,27782182,71084182,5,0,0,2560,25,2505993228
8132,43305300,40918950,84224250,9,0,1,8192,4,1039124358
8133,43307300,28117914,71425214,7,0,0,100864,21,1014623999
8134,43309380,40917456,84226836,4,0,1,4096,25,7341010486
8135,43311640,27998116,71309756,7,0,0,6144,21,9542405163
8136,43312400,40918302,84230702,4,0,1,6144,25,9752604924
8137,43317760,40929489,84247249,4,0,1,13312,25,2290834158
8138,43319760,40929435,84249195,0,0,1,3072,8,8610814017
8139,43327740,27898449,71226189,6,0,0,1024,17,9737949478
8140,43330290,27852549,71182839,9,0,0,1024,4,4420214314
8141,43331090,40921011,84252101,0,0,1,4608,8,7827794553
8142,43335660,28230283,71565943,7,0,0,9216,21,4651627594
8143,43335700,40922853,84258553,9,0,1,10240,4,10117180941
8144,43340750,40920069,84260819,9,0,1,3584,4,8498341954
8145,43344610,27963251,71307861,5,0,0,1536,25,9295340376
8146,43350320,28167103,71517423,1,0,0,109568,5,4437911005
8147,43357510,28092109,71449619,1,0,0,21504,5,5748846965
8148,43358000,28391536,71749536,1,0,0,94720,5,9048435166
8149,43358170,27866195,71224365,1,0,0,5120,5,7133836062
8150,43366220,28196620,71562840,7,0,0,39424,21,6177940949
8151,43367340,27818571,71185911,9,0,0,1024,4,2828495420
8152,43369871,40897056,84266927,5,0,1,36864,25,3990705354
8153,43371430,40912699,84284129,4,0,1,2048,25,8518841644
8154,43393241,40905831,84299072,5,0,1,15872,25,728047214
8155,43394170,27604803,70998973,5,0,0,1536,25,3969921742
8156,43398570,28232960,71631530,6,0,0,1024,17,8420846355
8157,43403360,40895735,84299095,4,0,1,1024,25,4660573257
8158,43411280,40887838,84299118,4,0,1,2048,25,2132713668
8159,43419009,40880132,84299141,8,0,1,3584,1,4902531054
8160,43426250,40872987,84299237,0,0,1,1536,8,2259333878
8161,43427780,40873199,84300979,9,0,1,14336,4,1261593414
8162,43431649,40869676,84301325,8,0,1,512,1,9712852651
8163,43451470,27858956,71310426,6,0,0,1536,17,720208164
8164,43459659,40842972,84302631,8,0,1,2048,1,8629375836
8165,43459890,28088388,71548278,9,0,0,512,4,7521794416
8166,43465191,40886668,84351859,5,0,1,96768,25,7321609319
8167,43471590,28129973,71601563,9,0,0,512,4,7165152716
8168,43478490,40873715,84352205,9,0,1,512,4,357571429
8169,43480151,40890815,84370966,5,0,1,26624,25,4922542720
8170,43480870,28302175,71783045,1,0,0,58368,5,2095199045
8171,43482050,40949674,84431724,9,0,1,1536,4,806465920
8172,43484010,27847838,71331848,5,0,0,1024,25,580839413
8173,43487859,40943888,84431747,3,0,1,512,21,7451129042
8174,43491590,27868404,71359994,9,0,0,1536,4,1710588920
8175,43493250,28380586,71873836,7,0,0,25600,21,7478189628
8176,43493640,28256456,71750096,5,0,0,1536,25,1474190136
8177,43494139,40937631,84431770,8,0,1,19456,1,4328834315
8178,43496501,40948915,84445416,5,0,1,23040,25,6249806758
8179,43508191,41052671,84560862,5,0,1,60928,25,801923910
8180,43512370,27871851,71384221,6,0,0,2048,17,3526010648
8181,43516410,41063987,84580397,2,0,1,5120,19,6174571760
8182,43519340,28201313,71720653,1,0,0,211968,5,3323503733
8183,43526020,28239016,71765036,9,0,0,19456,4,6770371472
8184,43527170,27922784,71449954,5,0,0,1024,25,2433070151
8185,43537230,28271334,71808564,9,0,0,39424,4,10293644161
8186,43541930,27975680,71517610,5,0,0,512,25,3115910393
8187,43551791,41031269,84583060,5,0,1,29184,25,7751926722
8188,43553130,41055817,84608947,9,0,1,8704,4,8142632152
8189,43558920,41138067,84696987,4,0,1,28160,25,10106435829
8190,43560970,27956975,71517945,6,0,0,1024,17,2285366066
8191,43564540,41132470,84697010,4,0,1,4608,25,3749721392
8192,43569610,28260599,71830209,9,0,0,68608,4,8935202342
8193,43575119,41121914,84697033,6,0,1,7680,17,6681899464
8194,43576571,41136202,84712773,5,0,1,8192,25,5910517002
8195,43577770,41135026,84712796,9,0,1,20480,4,8915021066
8196,43581570,27861474,71443044,6,0,0,1024,17,10284584953
8197,43581960,27966139,71548099,9,0,0,4608,4,2182952460
8198,43581970,28183245,71765215,6,0,0,512,17,5077660950
8199,43582000,28214529,71796529,6,0,0,1024,17,7592008342
8200,43596879,41120755,84717634,8,0,1,2048,1,6603490606
8201,43596969,41122931,84719900,6,0,1,3584,17,4050215845
8202,43601700,41122706,84724406,4,0,1,7168,25,3015018950
8203,43605171,41122461,84727632,6,0,1,5120,17,10720525194
8204,43608820,41121078,84729898,9,0,1,3584,4,4221715190
8205,43610890,41119994,84730884,4,0,1,1536,25,8291333328
8206,43611169,41124541,84735710,8,0,1,7680,1,8500555935
8207,43615420,28193799,71809219,5,0,0,1536,25,8703467225
8208,43619589,41116467,84736056,8,0,1,512,1,10219821102
8209,43620720,41119202,84739922,9,0,1,6144,4,8660366010
8210,43623520,41117068,84740588,9,0,1,1024,4,8245820570
8211,43634560,28021486,71656046,9,0,0,20992,4,5710569953
8212,43634850,41106724,84741574,4,0,1,1536,25,1908168858
8213,43636880,28322089,71958969,1,0,0,3072,5,5906122139
8214,43637449,41110530,84747979,8,0,1,6656,1,1497274859
8215,43641650,41109256,84750906,2,0,1,8192,19,2120790388
8216,43644939,41107593,84752532,6,0,1,2560,17,5876901929
8217,43646310,28149821,71796131,9,0,0,40448,4,1467085149
8218,43646670,41110048,84756718,4,0,1,6656,25,9463047304
8219,43649650,41109974,84759624,4,0,1,4608,25,9703868091
8220,43649900,41113910,84763810,4,0,1,6656,25,7034966998
8221,43650460,41114656,84765116,9,0,1,2048,4,4552356302
8222,43655460,41111282,84766742,4,0,1,2560,25,1682851553
8223,43655780,27895025,71550805,7,0,0,8192,21,2363663965
8224,43656490,41113709,84770199,2,0,1,16384,19,3854797191
8225,43656590,41116311,84772901,4,0,1,15872,25,3964838405
8226,43666029,41150329,84816358,6,0,1,8192,17,9939403625
8227,43670429,41145952,84816381,8,0,1,512,1,1754446964
8228,43671980,28166560,71838540,6,0,0,512,17,10433198014
8229,43683249,41133334,84816583,8,0,1,5120,1,69347585
8230,43690090,28068788,71758878,1,0,0,27648,5,7460166905
8231,43691810,28058621,71750431,6,0,0,1024,17,4763572782
8232,43695579,41121027,84816606,6,0,1,512,17,2607404272
8233,43696320,28314142,72010462,1,0,0,9216,5,5723409457
8234,43715500,41101129,84816629,2,0,1,17920,19,7858203864
8235,43716580,28248905,71965485,5,0,0,512,25,1678021831
8236,43718930,28349294,72068224,9,0,0,36352,4,10584048457
8237,43724050,41092602,84816652,2,0,1,2048,19,8266720322
8238,43725100,41091575,84816675,2,0,1,512,19,4108864007
8239,43725450,28111084,71836534,1,0,0,18944,5,9688570229
8240,43727970,41088728,84816698,2,0,1,512,19,5788115530
8241,43730470,28251257,71981727,6,0,0,1024,17,8412793985
8242,43731250,28161797,71893047,9,0,0,62976,4,5927185418
8243,43742479,41074733,84817212,6,0,1,3584,17,9281454081
8244,43748010,41069225,84817235,2,0,1,512,19,7343473357
8245,43756260,41060998,84817258,2,0,1,512,19,5961065351
8246,43759090,28024694,71783784,5,0,0,1536,25,3702349844
8247,43762529,41055094,84817623,8,0,1,3072,1,4008669011
8248,43764030,28066374,71830404,5,0,0,512,25,2120132471
8249,43765530,28017763,71783293,6,0,0,512,17,3304445372
8250,43772650,28214343,71986993,6,0,0,512,17,9657434680
8251,43777720,28053019,71830739,5,0,0,1024,25,2953955884
8252,43784640,28343751,72128391,1,0,0,159744,5,3740786701
8253,43787970,28536754,72324724,9,0,0,204800,4,2437424739
8254,43796090,28555072,72351162,7,0,0,24064,21,4079922252
8255,43801459,41017790,84819249,6,0,1,2560,17,2257256689
8256,43802250,41018625,84820875,2,0,1,2560,19,1630900024
8257,43808760,41012474,84821234,2,0,1,9728,19,3863122517
8258,43812989,41010511,84823500,8,0,1,3584,1,6031998335
8259,43815479,41009327,84824806,6,0,1,2048,17,1663288499
8260,43817940,41013430,84831370,9,0,1,6656,4,6899349561
8261,43820140,41012203,84832343,2,0,1,12800,19,1466779240
8262,43825339,41007350,84832689,8,0,1,512,1,10492072126
8263,43829200,41005609,84834809,9,0,1,3072,4,1085006869
8264,43829379,41006416,84835795,8,0,1,1536,1,9688297910
8265,43834700,28407331,72242031,7,0,0,98816,21,4883679730
8266,43862720,40974381,84837101,9,0,1,2048,4,10258887531
8267,43873220,27963985,71837205,6,0,0,2048,17,6312185367
8268,43875140,28258023,72133163,9,0,0,14848,4,8644931512
8269,43875919,40967616,84843535,6,0,1,7680,17,6115225199
8270,43876260,28252356,72128616,5,0,0,512,25,4855942390
8271,43886559,40961802,84848361,6,0,1,7680,17,10548216486
8272,43887569,40989551,84877120,6,0,1,2560,17,3389063819
8273,43891930,40991900,84883830,2,0,1,7168,19,5586793147
8274,43910469,40973392,84883861,6,0,1,2560,17,1357391698
8275,43916909,40968609,84885518,6,0,1,3584,17,5474396113
8276,43930079,40957525,84887604,8,0,1,2560,1,1845483875
8277,43931020,40961976,84892996,2,0,1,18944,19,6817260261
8278,43951121,28217424,72168545,2,0,0,20992,19,8199097764
8279,43956290,27997447,71953737,6,0,0,1024,17,9195300505
8280,43958229,40949215,84907444,3,0,1,5120,21,9344512380
8281,43959960,40947830,84907790,9,0,1,512,4,1616064036
8282,43961760,28115644,72077404,7,0,0,29696,21,8479824594
8283,43966269,40956405,84922674,3,0,1,7680,21,9403160399
8284,43975440,28405845,72381285,7,0,0,59904,21,3808105467
8285,43980029,40943951,84923980,8,0,1,2048,1,3250202375
8286,43981520,28033775,72015295,6,0,0,1536,17,6747722014
8287,43982389,40944826,84927215,6,0,1,1536,17,687132200
8288,43983769,40944112,84927881,3,0,1,1024,21,6070076491
8289,43986819,40943648,84930467,6,0,1,4096,17,9011445650
8290,43986859,40944274,84931133,3,0,1,1024,21,3646324179
8291,43992490,28350422,72342912,9,0,0,55296,4,1151834215
8292,43994110,28083473,72077583,6,0,0,512,17,3632883876
8293,44009340,40923419,84932759,2,0,1,2560,19,6282530987
8294,44017540,28243671,72261211,9,0,0,18432,4,7775292201
8295,44022719,40936684,84959403,6,0,1,7168,17,1421113134
8296,44028020,28297663,72325683,1,0,0,3072,5,3426973698
8297,44040429,40985256,85025685,3,0,1,25088,21,5375176847
8298,44040879,40987392,85028271,8,0,1,4096,1,6676681025
8299,44047380,28388536,72435916,7,0,0,38400,21,3991450991
8300,44056219,40972411,85028630,6,0,1,9728,17,8025366577
8301,44059970,28093460,72153430,9,0,0,20992,4,5181739495
8302,44062020,28300990,72363010,7,0,0,13824,21,8432425910
8303,44067731,28276007,72343738,2,0,0,512,19,8041151569
8304,44079240,40970655,85049895,2,0,1,24064,19,5063208519
8305,44082990,40977648,85060638,2,0,1,4096,19,3330768426
8306,44091650,28163922,72255572,7,0,0,9728,21,7468595361
8307,44097019,40991628,85088647,6,0,1,6656,17,8951096080
8308,44097720,40995779,85093499,6,0,1,7680,17,8436078289
8309,44098279,40996846,85095125,3,0,1,2560,21,1278673112
8310,44102429,40996562,85098991,3,0,1,6144,21,5125488005
8311,44107859,40995985,85103844,3,0,1,2560,21,6689585702
8312,44112699,40994232,85106931,3,0,1,1536,21,2538492481
8313,44114169,41008212,85122381,3,0,1,4608,21,6755808709
8314,44114761,28242056,72356817,2,0,0,18432,19,4110982862
8315,44122130,41024259,85146389,6,0,1,1536,17,8974360206
8316,44123559,41024136,85147695,6,0,1,2048,17,8181741196
8317,44126610,28230386,72356996,6,0,0,512,17,431742404
8318,44127700,28215859,72343559,9,0,0,2048,4,6125943384
8319,44129141,28427453,72556594,2,0,0,19968,19,2082302609
8320,44131630,41016629,85148259,2,0,1,10752,19,6873803621
8321,44133290,28329767,72463057,9,0,0,47616,4,9144609061
8322,44134869,41014376,85149245,3,0,1,1536,21,4240467485
8323,44148899,41025166,85174065,8,0,1,9216,1,830479412
8324,44150299,41026992,85177291,6,0,1,5120,17,1439512680
8325,44157660,28168358,72326018,6,0,0,1024,17,2517071141
8326,44161720,28252925,72414645,1,0,0,36352,5,4529564363
8327,44166950,28316714,72483664,1,0,0,33792,5,10219966049
8328,44169369,41008268,85177637,3,0,1,512,21,5013214513
8329,44176300,28319745,72496045,1,0,0,29184,5,7336473089
8330,44180060,28178675,72358735,9,0,0,5632,4,1875482100
8331,44181571,28550178,72731749,2,0,0,75264,19,4403945115
8332,44186940,28342690,72529630,6,0,0,2048,17,7061447575
8333,44191931,28515841,72707772,2,0,0,64512,19,820007575
8334,44192239,40987344,85179583,8,0,1,3072,1,4641877682
8335,44196190,28541512,72737702,7,0,0,6144,21,6499108671
8336,44200800,28745899,72946699,1,0,0,173568,5,8972884883
8337,44206620,28567975,72774595,9,0,0,33280,4,5531087656
8338,44210569,40969360,85179929,3,0,1,512,21,10153969784
8339,44215859,40966336,85182195,6,0,1,3584,17,10392534462
8340,44223640,28910413,73134053,9,0,0,25600,4,386958484
8341,44229799,40955622,85185421,3,0,1,5120,21,2656105004
8342,44246840,40976037,85222877,6,0,1,5632,17,2073819071
8343,44257829,40965071,85222900,6,0,1,512,17,505332515
8344,44262279,40960644,85222923,3,0,1,2560,21,3372037183
8345,44266449,40956497,85222946,6,0,1,5632,17,2285337533
8346,44266730,28588779,72855509,9,0,0,136192,4,7474032022
8347,44269921,40966812,85236733,5,0,1,19456,25,9006005055
8348,44271661,41019807,85291468,5,0,1,6656,25,6322068414
8349,44276120,28501774,72777894,9,0,0,10752,4,6664374337
8350,44276661,28705161,72981822,2,0,0,115200,19,9721233609
8351,44277880,28356276,72634156,7,0,0,11264,21,152955293
8352,44286440,28574240,72860680,9,0,0,16896,4,4807883151
8353,44298261,28701335,72999596,2,0,0,9728,19,10115981477
8354,44300410,28485151,72785561,0,0,0,25088,8,4617101502
8355,44301639,40989852,85291491,8,0,1,512,1,9575239114
8356,44306639,40984875,85291514,3,0,1,4608,21,5592683919
8357,44321799,40988559,85310358,3,0,1,1536,21,7539425061
8358,44323451,40993525,85316976,5,0,1,23552,25,2320863051
8359,44329261,28724618,73053879,2,0,0,67584,19,3954580392
8360,44342049,41035672,85377721,8,0,1,512,1,7388628172
8361,44348430,28648171,72996601,0,0,0,36864,8,6077660891
8362,44348739,41034128,85382867,3,0,1,8192,21,5423236739
8363,44356510,28698865,73055375,6,0,0,512,17,3520638964
8364,44377089,41027566,85404655,3,0,1,1536,21,2876641267
8365,44379060,28606286,72985346,7,0,0,11264,21,1332291268
8366,44381221,28619802,73001023,2,0,0,4608,19,8382127838
8367,44384931,28293254,72678185,2,0,0,3584,19,8898159728
8368,44394000,28854593,73248593,6,0,0,1024,17,811325613
8369,44395731,41368068,85763799,5,0,1,76800,25,323621788
8370,44395839,41499280,85895119,3,0,1,1024,21,8380574360
8371,44412151,28711575,73123726,2,0,0,32256,19,7921193049
8372,44416180,28689432,73105612,1,0,0,74752,5,8724324593
8373,44422631,41476914,85899545,5,0,1,45568,25,1091179365
8374,44433001,28600263,73033264,2,0,0,24576,19,5900920122
8375,44461051,41486542,85947593,7,0,1,14848,21,2407523262
8376,44462020,28762788,73224808,0,0,0,60416,8,9322989322
8377,44469841,28982326,73452167,2,0,0,103424,19,7457291010
8378,44470020,28590827,73060847,6,0,0,13312,17,496473778
8379,44475780,28579370,73055150,6,0,0,4096,17,7075157163
8380,44477080,28706329,73183409,0,0,0,36352,8,1721300598
8381,44488921,41624542,86113463,7,0,1,25600,21,7541299688
8382,44490601,29392001,73882602,2,0,0,33792,19,6138810972
8383,44495570,28773554,73269124,9,0,0,44544,4,8851944508
8384,44497770,41692068,86189838,4,0,1,512,25,2987136890
8385,44508300,29523459,74031759,6,0,0,38912,17,1807585891
8386,44511621,28717312,73228933,2,0,0,13312,19,7242492438
8387,44513610,29239019,73752629,9,0,0,19968,4,10424084515
8388,44522621,41667240,86189861,5,0,1,5632,25,8977654828
8389,44524061,28799710,73323771,2,0,0,11264,19,177922617
8390,44536100,29336175,73872275,7,0,0,38912,21,3708471558
8391,44542191,28926090,73468281,2,0,0,52736,19,454257001
8392,44542261,41966107,86508368,7,0,1,67072,21,6161841927
8393,44560291,41948100,86508391,5,0,1,9728,25,2298276055
8394,44571520,28941385,73512905,1,0,0,110080,5,7920411559
8395,44572181,42134674,86706855,5,0,1,108032,25,3807593056
8396,44576140,29152402,73728542,6,0,0,30208,17,7181746547
8397,44578130,29398040,73976170,9,0,0,5632,4,9942256474
8398,44587891,42126074,86713965,7,0,1,7680,21,2872824965
8399,44612361,42283613,86895974,7,0,1,61440,21,7524714562
8400,44631871,42283819,86915690,5,0,1,12288,25,2601847810
8401,44638470,28759937,73398407,1,0,0,22528,5,3869359308
8402,44647490,29304678,73952168,6,0,0,52224,17,8024888935
8403,44652101,29191994,73844095,2,0,0,33280,19,6292868771
8404,44660700,29496592,74157292,0,0,0,34816,8,9555693742
8405,44669550,29164313,73833863,1,0,0,106496,5,728463688
8406,44675050,28863037,73538087,7,0,0,67584,21,6723093963
8407,44697621,29386003,74083624,2,0,0,49664,19,382079818
8408,44698760,28708734,73407494,1,0,0,7168,5,10238608776
8409,44701060,29445383,74146443,7,0,0,48128,21,8579847779
8410,44703520,28528446,73231966,1,0,0,9728,5,6722292966
8411,44711840,29300817,74012657,6,0,0,67072,17,1022834593
8412,44723500,28921752,73645252,1,0,0,112640,5,10026500519
8413,44727820,29163073,73890893,7,0,0,27136,21,2821444999
8414,44734231,42450829,87185060,7,0,1,177664,21,7618329006
8415,44741780,29434891,74176671,7,0,0,56320,21,4985682386
8416,44747721,42461606,87209327,7,0,1,23552,21,670002016
8417,44748490,29634747,74383237,1,0,0,20992,5,10694736236
8418,44749580,29485088,74234668,7,0,0,157696,21,6449301443
8419,44754270,29807216,74561486,0,0,0,26112,8,6223954733
8420,44756550,29492828,74249378,9,0,0,9216,4,6096791151
8421,44780900,29798393,74579293,6,0,0,58368,17,9034200334
8422,44780920,29572608,74353528,0,0,0,226816,8,1626370282
8423,44803241,42631353,87434594,5,0,1,92672,25,9354974129
8424,44812540,29731819,74544359,6,0,0,6144,17,8140136801
8425,44812821,29047567,73860388,2,0,0,53248,19,10184350669
8426,44825820,29305936,74131756,0,0,0,22016,8,6797648296
8427,44831621,28849214,73680835,2,0,0,5120,19,2743015189
8428,44845030,29617025,74462055,6,0,0,163328,17,3939751048
8429,44848211,30197130,75045341,2,0,0,49152,19,615332149
8430,44852990,29559278,74412268,6,0,0,87552,17,1714825452
8431,44853400,29759174,74612574,9,0,0,8704,4,9485837353
8432,44855401,29811388,74666789,2,0,0,61440,19,4804822872
8433,44871291,42568543,87439834,5,0,1,28672,25,6586752765
8434,44884850,29617343,74502193,9,0,0,131584,4,7841147412
8435,44900020,30152699,75052719,1,0,0,13312,5,2003152435
8436,44903000,29365612,74268612,9,0,0,35328,4,5123595897
8437,44904200,30322755,75226955,1,0,0,119808,5,4442044052
8438,44904529,42541435,87445964,6,0,1,2560,17,5193477208
8439,44913510,30015785,74929295,0,0,0,7168,8,2018282075
8440,44913650,29446609,74360259,1,0,0,22016,5,4026343371
8441,44915600,29833273,74748873,0,0,0,9216,8,815715358
8442,44916131,42568099,87484230,5,0,1,20480,25,8297957217
8443,44920891,42563378,87484269,5,0,1,31744,25,1510271770
8444,44923940,28870015,73793955,0,0,0,17408,8,4829022465
8445,44925331,29332494,74257825,2,0,0,27648,19,4267262534
8446,44929690,29033592,73963282,6,0,0,8704,17,8405683810
8447,44930550,29194475,74125025,0,0,0,19968,8,7770265899
8448,44940820,42598453,87539273,4,0,1,8704,25,1608262746
8449,44954009,42585287,87539296,3,0,1,8192,21,10130419127
8450,44955310,29291237,74246547,9,0,0,38912,4,10183202827
8451,44957731,29419087,74376818,2,0,0,54272,19,2371617788
8452,44965450,42573869,87539319,4,0,1,10752,25,2615038186
8453,44973140,29636751,74609891,7,0,0,73216,21,3735166703
8454,44973480,29568984,74542464,6,0,0,132096,17,3445175100
8455,44975301,42564041,87539342,5,0,1,512,25,2764330133
8456,44977870,29908907,74886777,6,0,0,39936,17,3507876109
8457,44988790,42550575,87539365,2,0,1,13312,19,6720190481
8458,44990611,30022556,75013167,2,0,0,125952,19,1579890613
8459,44991530,29596030,74587560,6,0,0,11264,17,1635736737
8460,45009250,29574839,74584089,6,0,0,15360,17,8089812742
8461,45011000,42546671,87557671,4,0,1,13824,25,8543690754
8462,45013250,29710605,74723855,0,0,0,2560,8,6031750137
8463,45030259,42527451,87557710,3,0,1,5120,21,8212176617
8464,45057160,29566723,74623883,7,0,0,14848,21,6458531325
8465,45060140,29493001,74553141,7,0,0,18432,21,5499024289
8466,45065361,42492372,87557733,5,0,1,4608,25,2057078233
8467,45071611,42499270,87570881,5,0,1,1024,25,10055480071
8468,45075931,42495296,87571227,5,0,1,512,25,1901660761
8469,45085140,29660902,74746042,6,0,0,64512,17,1384136402
8470,45085560,29533776,74619336,7,0,0,22016,21,1549158790
8471,45086520,42488893,87575413,4,0,1,6656,25,6730242826
8472,45090980,29605761,74696741,9,0,0,28672,4,6703720803
8473,45095029,42582554,87677583,1,0,1,5632,5,4593485678
8474,45098600,30185721,75284321,9,0,0,29696,4,3935027774
8475,45104160,29443342,74547502,6,0,0,10240,17,10676270880
8476,45110141,42578679,87688820,5,0,1,8192,25,2998388168
8477,45116349,42666269,87782618,6,0,1,512,17,1412973774
8478,45116901,42667663,87784564,5,0,1,3072,25,6406660920
8479,45119859,42666971,87786830,8,0,1,3584,1,4741755199
8480,45122410,29431074,74553484,6,0,0,1024,17,10215239894
8481,45132539,42654957,87787496,3,0,1,11264,21,1847977300
8482,45135170,30180806,75315976,1,0,0,72704,5,1218622644
8483,45145519,42689755,87835274,8,0,1,5120,1,5333125218
8484,45146120,29481561,74627681,7,0,0,12288,21,9198269724
8485,45156750,29908079,75064829,9,0,0,12288,4,1822031468
8486,45156769,42679171,87835940,3,0,1,1024,21,2274998824
8487,45162500,29603114,74765614,1,0,0,12800,5,3363767049
8488,45163640,42674886,87838526,4,0,1,4096,25,5802612083
8489,45164801,30217380,75382181,2,0,0,51200,19,1962302844
8490,45172970,29675409,74848379,6,0,0,2560,17,9727895790
8491,45175500,29949309,75124809,0,0,0,113152,8,8216200224
8492,45177500,29520657,74698157,9,0,0,3072,4,4990773624
8493,45179041,42664311,87843352,5,0,1,7680,25,1678022394
8494,45180169,42673534,87853703,8,0,1,4608,1,9248114184
8495,45181411,42750548,87931959,5,0,1,1024,25,683205212
8496,45183570,29565505,74749075,6,0,0,512,17,9794359363
8497,45188130,42744495,87932625,4,0,1,11264,25,3880796481
8498,45191941,42741030,87932971,5,0,1,512,25,8870961673
8499,45193030,42744613,87937643,4,0,1,4608,25,3248407955
8500,45193320,29697464,74890784,6,0,0,512,17,8491875258
8501,45194900,29764950,74959850,7,0,0,56832,21,563680072
8502,45197419,42919492,88116911,3,0,1,512,21,8657840553
8503,45203540,29757269,74960809,1,0,0,3072,5,8286190838
8504,45204871,29701910,74906781,2,0,0,14848,19,9962412305
8505,45213419,42903515,88116934,3,0,1,1024,21,6941503187
8506,45220530,30101287,75321817,0,0,0,4608,8,5547486006
8507,45221840,29803206,75025046,7,0,0,38912,21,10239375407
8508,45228959,42887998,88116957,8,0,1,9216,1,5477675595
8509,45235440,29789808,75025248,6,0,0,512,17,1473484774
8510,45241489,42935058,88176547,8,0,1,12288,1,5593960074
8511,45254061,42922509,88176570,5,0,1,9728,25,3569996236
8512,45257100,29706852,74963952,9,0,0,10240,4,4889140578
8513,45258341,42936017,88194358,5,0,1,2560,25,1715515524
8514,45259571,42935453,88195024,5,0,1,1024,25,2600400417
8515,45260099,42977202,88237301,8,0,1,17920,1,2818204772
8516,45264870,29788184,75053054,6,0,0,1024,17,9242271579
8517,45266751,43015422,88282173,5,0,1,512,25,5514064752
8518,45268370,29601890,74870260,6,0,0,1024,17,4789308737
8519,45269030,29666373,74935403,1,0,0,8704,5,9971169701
8520,45271871,43010325,88282196,5,0,1,4096,25,9523861323
8521,45274869,43007350,88282219,8,0,1,512,1,869391360
8522,45283879,42998363,88282242,8,0,1,1024,1,8193700723
8523,45286389,42995876,88282265,1,0,1,2048,5,3659849357
8524,45303899,43011434,88315333,1,0,1,512,5,7147459527
8525,45307130,43008226,88315356,4,0,1,9216,25,1304841736
8526,45311390,29628129,74939519,6,0,0,2048,17,10471841971
8527,45311391,43003988,88315379,5,0,1,1024,25,6987550703
8528,45313671,43001731,88315402,5,0,1,2048,25,4801570933
8529,45314530,29765419,75079949,9,0,0,19456,4,6647429865
8530,45317100,30003290,75320390,9,0,0,14336,4,3071839752
8531,45324771,29803961,75128732,2,0,0,12800,19,9654637411
8532,45340701,42974724,88315425,5,0,1,11264,25,3577776672
8533,45341400,30114061,75455461,1,0,0,10240,5,995405137
8534,45349221,29882350,75231571,2,0,0,12800,19,2658344049
8535,45350550,29785808,75136358,0,0,0,24576,8,6217380372
8536,45353700,29694940,75048640,1,0,0,10752,5,5890799253
8537,45357619,42983230,88340849,8,0,1,1024,1,2012150761
8538,45358310,29869315,75227625,1,0,0,1024,5,10018746877
8539,45359010,29807292,75166302,1,0,0,3072,5,1138678004
8540,45364190,42977325,88341515,4,0,1,1024,25,8093133386
8541,45367120,30052336,75419456,1,0,0,58368,5,9631933099
8542,45381550,30203695,75585245,7,0,0,4608,21,2138286690
8543,45401670,29999566,75401236,0,0,0,62464,8,2889594622
8544,45434760,30529984,75964744,9,0,0,81408,4,8050661608
8545,45440470,42901391,88341861,4,0,1,512,25,6881421308
8546,45446940,29737611,75184551,0,0,0,12800,8,8868327504
8547,45460369,42911968,88372337,3,0,1,2048,21,8228100775
8548,45465699,42906661,88372360,1,0,1,7168,5,2374396668
8549,45466471,42905912,88372383,5,0,1,10240,25,5944265948
8550,45468309,42904097,88372406,1,0,1,7168,5,8851753134
8551,45468350,42904079,88372429,4,0,1,3072,25,1543399794
8552,45468740,42903712,88372452,4,0,1,1024,25,5728077005
8553,45473190,42899285,88372475,4,0,1,7168,25,9284499743
8554,45480590,29746700,75227290,6,0,0,1024,17,10525655382
8555,45483840,42888658,88372498,4,0,1,7680,25,7120985949
8556,45493290,42898895,88392185,4,0,1,9216,25,4002758313
8557,45497440,29954878,75452318,7,0,0,40960,21,7887975622
8558,45504239,42891812,88396051,1,0,1,6144,5,9846083438
8559,45515291,29834937,75350228,2,0,0,2560,19,2006875400
8560,45520830,42911994,88432824,4,0,1,4608,25,9206862462
8561,45524600,30112853,75637453,1,0,0,13312,5,2809906183
8562,45528740,30175266,75704006,0,0,0,12800,8,2984095940
8563,45534659,42902671,88437330,8,0,1,7168,1,6214476224
8564,45537179,42900612,88437791,1,0,1,10240,5,1077188709
8565,45540349,42975031,88515380,1,0,1,14336,5,672140209
8566,45543499,42971904,88515403,1,0,1,1536,5,3505436415
8567,45543680,29945040,75488720,7,0,0,51200,21,2022866044
8568,45554130,29942457,75496587,9,0,0,11776,4,9959091961
8569,45558630,30371545,75930175,9,0,0,22016,4,9441846944
8570,45563650,30639725,76203375,0,0,0,4096,8,5133029513
8571,45564099,42951327,88515426,8,0,1,2560,1,3495436250
8572,45566610,42948839,88515449,2,0,1,8704,19,2220999898
8573,45572219,42943253,88515472,1,0,1,6656,5,2883682406
8574,45580780,42937544,88518324,2,0,1,7680,19,8510692118
8575,45583630,29905581,75489211,7,0,0,1536,21,4302714602
8576,45586271,29957133,75543404,2,0,0,1024,19,1105210570
8577,45589281,29878940,75468221,2,0,0,1024,19,5294085034
8578,45591310,30341597,75932907,6,0,0,2560,17,7922035726
8579,45593530,42925140,88518670,4,0,1,512,25,9979635181
8580,45593820,30608284,76202104,0,0,0,208896,8,8061083173
8581,45594069,42927507,88521576,8,0,1,4608,1,2989408031
8582,45596940,30648031,76244971,9,0,0,82432,4,6132635611
8583,45603199,42979934,88583133,8,0,1,512,1,7267475986
8584,45607050,30025833,75632883,0,0,0,111104,8,7535788296
8585,45608340,30509166,76117506,7,0,0,94208,21,10298522166
8586,45611709,42972090,88583799,1,0,1,1024,5,5625852088
8587,45623810,30130885,75754695,0,0,0,75264,8,9647882730
8588,45629469,42958196,88587665,8,0,1,6144,1,3764036585
8589,45636930,42951081,88588011,4,0,1,512,25,2427836304
8590,45638019,42953218,88591237,8,0,1,5120,1,2905340263
8591,45640420,30039432,75679852,7,0,0,25088,21,1244986511
8592,45647690,30032341,75680031,6,0,0,512,17,9062939963
8593,45648750,29862093,75510843,6,0,0,512,17,9497066490
8594,45649931,29983443,75633374,2,0,0,1536,19,626906934
8595,45652059,42992266,88644325,8,0,1,5120,1,3540172339
8596,45652929,43074342,88727271,8,0,1,15360,1,2212228780
8597,45653630,43113258,88766888,4,0,1,2048,25,7894069677
8598,45657380,30205214,75862594,0,0,0,74240,8,8304349194
8599,45677281,30213975,75891256,2,0,0,1536,19,3813168503
8600,45679360,30187313,75866673,0,0,0,13312,8,968851024
8601,45679869,43087042,88766911,1,0,1,512,5,8836876427
8602,45679910,30627308,76307218,0,0,0,15872,8,7802798073
8603,45686270,30236995,75923265,1,0,0,72704,5,6542921890
8604,45703740,30578272,76282012,7,0,0,121344,21,3721369914
8605,45703971,30168426,75872397,2,0,0,1536,19,4498703163
8606,45707059,43059875,88766934,8,0,1,1536,1,9258979054
8607,45711991,30595406,76307397,2,0,0,512,19,7702098811
8608,45725960,43040997,88766957,4,0,1,1024,25,1686012807
8609,45727250,30313274,76040524,9,0,0,64512,4,829245247
8610,45729730,43037250,88766980,4,0,1,10240,25,7648237151
8611,45731280,30581132,76312412,0,0,0,16384,8,8844967141
8612,45732350,29962083,75694433,9,0,0,10240,4,8815255964
8613,45743749,43083686,88827435,8,0,1,1536,1,633028942
8614,45747680,30764192,76511872,7,0,0,167936,21,3897383426
8615,45750340,30469492,76219832,1,0,0,51712,5,5224669676
8616,45753930,30768064,76521994,0,0,0,26624,8,10321802728
8617,45754740,30265492,76020232,7,0,0,30720,21,3487888175
8618,45762710,30302642,76065352,6,0,0,512,17,9597320417
8619,45765860,30372573,76138433,7,0,0,68608,21,8533552981
8620,45769940,30572594,76342534,6,0,0,512,17,6778441593
8621,45775600,30525091,76300691,6,0,0,1024,17,4572431539
8622,45786830,30555470,76342300,0,0,0,97792,8,7693857450
8623,45803181,30025676,75828857,2,0,0,512,19,7041955760
8624,45809080,30491253,76300333,9,0,0,4608,4,155920152
8625,45818731,30482802,76301533,2,0,0,512,19,4129335011
8626,45820950,30541598,76362548,7,0,0,7680,21,1922709426
8627,45822491,30479845,76302336,2,0,0,2560,19,2991380267
8628,45824900,30922326,76747226,9,0,0,18944,4,6963465221
8629,45836020,30087424,75923444,9,0,0,512,4,10577003977
8630,45839900,42987799,88827699,4,0,1,9728,25,1048968471
8631,45844040,30903365,76747405,6,0,0,512,17,6636889103
8632,45851800,30439751,76291551,9,0,0,31232,4,8854098379
8633,45857690,30507533,76365223,7,0,0,8704,21,8694464657
8634,45860900,30187046,76047946,9,0,0,4608,4,2471117097
8635,45869090,30579050,76448140,1,0,0,104960,5,10129117387
8636,45873650,30425256,76298906,9,0,0,24064,4,4222313353
8637,45880701,30323344,76204045,2,0,0,1536,19,6583099520
8638,45889340,30470845,76360185,1,0,0,57856,5,7385657538
8639,45899740,30303814,76203554,6,0,0,512,17,5660351857
8640,45911420,30614973,76526393,9,0,0,14336,4,2199702247
8641,45915600,30385754,76301354,6,0,0,2048,17,2368611600
8642,45917450,30490759,76408209,7,0,0,4096,21,10551234523
8643,45921490,42939991,88861481,4,0,1,4608,25,6871358366
8644,45922510,30590858,76513368,0,0,0,3584,8,893207697
8645,45925270,30489202,76414472,0,0,0,20480,8,8423820743
8646,45930710,42932077,88862787,4,0,1,2048,25,4734309955
8647,45943590,30472193,76415783,7,0,0,2560,21,1270841176
8648,45944110,30641057,76585167,1,0,0,32768,5,8201294223
8649,45951150,42913263,88864413,4,0,1,2560,25,7917866651
8650,45955050,30459601,76414651,6,0,0,512,17,3329103036
8651,45962830,42913971,88876801,9,0,1,14848,4,7905041076
8652,45973660,30538547,76512207,6,0,0,1024,17,1867879033
8653,45974180,30474809,76448989,1,0,0,2048,5,5474548018
8654,45981220,30657750,76638970,1,0,0,44544,5,5508024768
8655,45993581,30520278,76513859,2,0,0,1536,19,694168987
8656,45993800,30747623,76741423,1,0,0,28672,5,8025326967
8657,46001390,30764989,76766379,6,0,0,2048,17,10457035897
8658,46004450,30443869,76448319,6,0,0,512,17,2299469405
8659,46011940,30694759,76706699,1,0,0,41984,5,9516032739
8660,46018180,31003975,77022155,1,0,0,91648,5,3267394744
8661,46018800,30810147,76828947,7,0,0,46080,21,6714166396
8662,46020180,42928579,88948759,4,0,1,5632,25,9108106937
8663,46023790,42924992,88948782,4,0,1,6656,25,1483291146
8664,46029040,42934584,88963624,4,0,1,7168,25,10384988213
8665,46031570,30763848,76795418,1,0,0,23040,5,3450800582
8666,46034790,30654235,76689025,9,0,0,40448,4,1029281905
8667,46057560,30636324,76693884,9,0,0,15872,4,9293066908
8668,46066350,30586087,76652437,6,0,0,1024,17,8520036974
8669,46069881,42923735,88993616,5,0,1,5632,25,8815224946
8670,46070430,30842123,76912553,0,0,0,80896,8,6389140250
8671,46087870,30469838,76557708,6,0,0,36352,17,1178446402
8672,46091910,30780953,76872863,7,0,0,42496,21,1942217695
8673,46116241,30713041,76829282,2,0,0,1024,19,10215875523
8674,46117010,31094510,77211520,0,0,0,2048,8,2146414840
8675,46119231,30693160,76812391,2,0,0,512,19,394493613
8676,46123280,30609205,76732485,0,0,0,51200,8,2944654498
8677,46127630,30589232,76716862,1,0,0,33280,5,4758197314
8678,46127780,30813221,76941001,9,0,0,3072,4,3607513246
8679,46131990,30928434,77060424,1,0,0,15360,5,2994176713
8680,46142681,30531237,76673918,2,0,0,512,19,2802686002
8681,46144350,30614306,76758656,7,0,0,15360,21,3074429497
8682,46146560,31018174,77164734,1,0,0,109568,5,6792445063
8683,46160850,30642391,76803241,1,0,0,25600,5,6920943037
8684,46168261,30564403,76732664,2,0,0,512,19,10267013979
8685,46173510,42820129,88993639,4,0,1,512,25,403813582
8686,46174430,30747633,76922063,6,0,0,8192,17,1425799564
8687,46189930,30794914,76984844,1,0,0,23552,5,6623273414
8688,46192750,42810451,89003201,4,0,1,1536,25,6135515136
8689,46196781,30730812,76927593,2,0,0,1024,19,10289449322
8690,46207200,30980059,77187259,6,0,0,32256,17,6013801468
8691,46214440,30851278,77065718,0,0,0,512,8,4158339546
8692,46214720,42840233,89054953,4,0,1,4608,25,3047023753
8693,46218910,31189422,77408332,6,0,0,66560,17,6473467584
8694,46219830,42873911,89093741,4,0,1,3072,25,5050297392
8695,46229321,42872422,89101743,5,0,1,18944,25,243308676
8696,46232631,42869135,89101766,5,0,1,2048,25,1787347490
8697,46235380,42934428,89169808,4,0,1,2048,25,5209919170
8698,46242211,30945227,77187438,2,0,0,512,19,1907455262
8699,46252850,30846777,77099627,7,0,0,3072,21,398524466
8700,46256180,30989616,77245796,6,0,0,5632,17,7343956665
8701,46257021,42915053,89172074,5,0,1,3584,25,2794065541
8702,46258100,30981624,77239724,6,0,0,20992,17,2228947896
8703,46263320,30942297,77205617,0,0,0,53760,8,465936914
8704,46286960,30739921,77026881,9,0,0,6144,4,9966330066
8705,46287520,30811148,77098668,0,0,0,104960,8,4850598964
8706,46294260,30875512,77169772,6,0,0,4096,17,94910370
8707,46296650,30728336,77024986,9,0,0,9216,4,8922314897
8708,46296681,30935968,77232649,2,0,0,512,19,1719613465
8709,46301841,42879964,89181805,5,0,1,7680,25,4050841526
8710,46313020,31075009,77388029,7,0,0,19968,21,1613858737
8711,46316600,30801013,77117613,1,0,0,58368,5,8787568403
8712,46318130,30986759,77304889,9,0,0,76288,4,8977638535
8713,46319850,30848651,77168501,7,0,0,12288,21,2934578281
8714,46325581,30774225,77099806,2,0,0,512,19,8427961997
8715,46333031,30877842,77210873,2,0,0,1024,19,551304827
8716,46339130,31042792,77381922,1,0,0,119808,5,7223081114
8717,46340400,30870130,77210530,6,0,0,15872,17,4561738533
8718,46350141,30893133,77243274,2,0,0,512,19,4237385846
8719,46351070,30979264,77330334,0,0,0,512,8,7172786676
8720,46352061,30818046,77170107,2,0,0,1024,19,9610677419
8721,46365331,42818420,89183751,5,0,1,3072,25,1407496853
8722,46366720,42824893,89191613,4,0,1,1024,25,2362661257
8723,46374570,42822189,89196759,4,0,1,8192,25,1734759177
8724,46382700,31065287,77447987,7,0,0,34816,21,5808860021
8725,46391451,42871079,89262530,7,0,1,2560,21,3639958064
8726,46393680,31069094,77462774,9,0,0,3072,4,4181048215
8727,46394621,42867932,89262553,7,0,1,29184,21,3874130438
8728,46398110,31246597,77644707,0,0,0,172032,8,9991219406
8729,46404001,30916153,77320154,2,0,0,1536,19,5057547483
8730,46410980,30930364,77341344,1,0,0,8704,5,5023352936
8731,46413010,31278296,77691306,9,0,0,128512,4,5205265409
8732,46414030,31308085,77722115,7,0,0,63488,21,449924939
8733,46421350,42845921,89267271,4,0,1,6144,25,6096390239
8734,46421590,31138700,77560290,0,0,0,10240,8,2958694047
8735,46424990,31313528,77738518,1,0,0,53760,5,9566584442
8736,46433290,42854458,89287748,4,0,1,2048,25,4737166171
8737,46434331,42857466,89291797,5,0,1,6656,25,8706444945
8738,46436370,42856912,89293282,4,0,1,15360,25,720781499
8739,46442470,31457867,77900337,0,0,0,89600,8,7754837570
8740,46444530,42851978,89296508,4,0,1,5120,25,1191613190
8741,46445201,42852933,89298134,5,0,1,2560,25,7723836914
8742,46452690,42851550,89304240,4,0,1,20992,25,3400904562
8743,46454480,42902995,89357475,4,0,1,14336,25,3774353318
8744,46461530,30959230,77420760,7,0,0,9216,21,7996145719
8745,46469450,42888691,89358141,4,0,1,1024,25,115639639
8746,46472271,42886856,89359127,7,0,1,1536,21,617141283
8747,46475011,42984767,89459778,7,0,1,20992,21,1647479449
8748,46475540,31227208,77702748,6,0,0,37376,17,53347509
8749,46477010,31276809,77753819,7,0,0,46592,21,5249817468
8750,46483271,43007142,89490413,7,0,1,26624,21,1072162444
8751,46485320,43067108,89552428,4,0,1,2560,25,8682170451
8752,46497751,43058223,89555974,5,0,1,5632,25,10267584049
8753,46505900,31522346,78028246,6,0,0,33280,17,8123472870
8754,46506770,31145357,77652127,6,0,0,22528,17,4439965498
8755,46510080,43047200,89557280,4,0,1,2048,25,5750719644
8756,46512250,31442157,77954407,0,0,0,41984,8,46596320
8757,46512980,31489342,78002322,1,0,0,157184,5,6791245952
8758,46515330,31356823,77872153,6,0,0,27136,17,8268175144
8759,46520641,43070786,89591427,7,0,1,37888,21,2133622003
8760,46525491,43133748,89659239,5,0,1,1536,25,463900479
8761,46526160,31278943,77805103,1,0,0,23040,5,7243810803
8762,46532871,31206729,77739600,2,0,0,3072,19,9078194923
8763,46533800,31407112,77940912,0,0,0,40960,8,9393667394
8764,46564750,31764445,78329195,9,0,0,14848,4,5905185015
8765,46566561,43134301,89700862,7,0,1,66560,21,614969326
8766,46566890,31685052,78251942,6,0,0,19456,17,7655412427
8767,46568720,31761278,78329998,9,0,0,2560,4,8000816036
8768,46571780,31501649,78073429,0,0,0,25088,8,329160244
8769,46604740,31636384,78241124,6,0,0,57856,17,6110809209
8770,46615940,31708373,78324313,9,0,0,204800,4,9795298969
8771,46621180,31784250,78405430,9,0,0,29184,4,7313010189
8772,46623980,31495107,78119087,6,0,0,61952,17,6631148832
8773,46639450,31606533,78245983,9,0,0,15872,4,9222390409
8774,46649030,43055625,89704655,9,0,1,512,4,3431419313
8775,46650280,31475850,78126130,0,0,0,23040,8,9732434322
8776,46650861,43054460,89705321,5,0,1,1024,25,5577098279
8777,46655130,31347371,78002501,9,0,0,512,4,10010959999
8778,46656401,43143896,89800297,7,0,1,47104,21,9192611441
8779,46656950,31888615,78545565,1,0,0,99328,5,3223470959
8780,46663140,31496067,78159207,7,0,0,13312,21,2710250965
8781,46673731,31877527,78551258,2,0,0,512,19,4909852116
8782,46674040,31780732,78454772,0,0,0,161792,8,10610453936
8783,46676451,43176056,89852507,7,0,1,20480,21,1044921280
8784,46691661,43160869,89852530,7,0,1,512,21,6289050287
8785,46720780,31664212,78384992,7,0,0,26112,21,5023030281
8786,46723580,31369709,78093289,7,0,0,34816,21,9088387194
8787,46734780,31949792,78684572,7,0,0,38400,21,1632428829
8788,46748540,31766738,78515278,1,0,0,67072,5,2659523052
8789,46755420,31503721,78259141,7,0,0,23552,21,6468053273
8790,46764339,43088214,89852553,3,0,1,9216,21,7450451191
8791,46769430,32102161,78871591,7,0,0,40448,21,10459061310
8792,46775950,31775129,78551079,9,0,0,17408,4,886529516
8793,46796351,31528297,78324648,2,0,0,1024,19,6179211887
8794,46799711,31657938,78457649,2,0,0,512,19,8378683302
8795,46812101,31645819,78457920,2,0,0,512,19,4666009516
8796,46813270,43040599,89853869,9,0,1,4096,4,5212518386
8797,46818140,31318021,78136161,0,0,0,13824,8,9762751742
8798,46820300,31378421,78198721,6,0,0,512,17,2473065315
8799,46822210,31635260,78457470,9,0,0,8704,4,10267583406
8800,46843500,43012635,89856135,0,0,1,3584,8,8195654359
8801,46846130,31706407,78552537,1,0,0,4096,5,3638672441
8802,46857260,43013407,89870667,2,0,1,13824,19,10095186462
8803,46858971,43385742,90244713,7,0,1,136704,21,5141361369
8804,46872181,31730449,78602630,2,0,0,1024,19,2416300569
8805,46873660,31795734,78669394,1,0,0,76288,5,7447035594
8806,46878990,32197330,79076320,6,0,0,96768,17,7195972005
8807,46881440,31725410,78606850,7,0,0,6144,21,3652516788
8808,46889020,32055910,78944930,7,0,0,7168,21,6615922660
8809,46892480,31957670,78850150,1,0,0,135680,5,6570381949
8810,46900940,43343796,90244736,0,0,1,512,8,2688838353
8811,46906971,31790011,78696982,2,0,0,1024,19,3383635004
8812,46907940,32034783,78942723,0,0,0,10240,8,6927022330
8813,46911280,43333479,90244759,9,0,1,512,4,5479380547
8814,46926300,31783017,78709317,7,0,0,1024,21,9260970748
8815,46926841,31618903,78545744,2,0,0,512,19,6366822027
8816,46943381,31609335,78552716,2,0,0,512,19,9277644366
8817,46951560,31907661,78859221,7,0,0,29696,21,832474850
8818,46951660,32184582,79136242,0,0,0,8704,8,8963378401
8819,46958290,43286492,90244782,0,0,1,19456,8,8286209709
8820,46959970,31815108,78775078,9,0,0,15360,4,710708242
8821,46959990,43284815,90244805,0,0,1,4096,8,10438941418
8822,46961300,43283528,90244828,0,0,1,4096,8,6405118644
8823,46961891,32030778,78992669,9,0,0,19968,4,2708474642
8824,46989870,32411670,79401540,1,0,0,19968,5,4327700724
8825,46990220,32056593,79046813,0,0,0,36352,8,9774395102
8826,46991540,32198321,79189861,0,0,0,107008,8,8479126271
8827,46992691,31967849,78960540,9,0,0,16896,4,4739504535
8828,46995820,32033227,79029047,0,0,0,24064,8,7465841461
8829,47002760,43242091,90244851,0,0,1,1024,8,645673584
8830,47005070,31934510,78939580,7,0,0,70144,21,835933113
8831,47005900,32204755,79210655,0,0,0,68096,8,9253637503
8832,47023110,31852451,78875561,1,0,0,12800,5,2840306401
8833,47027731,43217143,90244874,5,0,1,3584,25,7338221447
8834,47028240,43216657,90244897,0,0,1,11264,8,9612679805
8835,47031720,31947081,78978801,6,0,0,18944,17,6414105798
8836,47032560,31989132,79021692,1,0,0,88576,5,2130894623
8837,47032750,32381940,79414690,0,0,0,43008,8,394601287
8838,47035911,32284390,79320301,9,0,0,122880,4,8306535040
8839,47036591,43240545,90277136,5,0,1,2560,25,7885594775
8840,47037410,31761758,78799168,1,0,0,2560,5,4319374122
8841,47043090,32114144,79157234,0,0,0,36864,8,3576647303
8842,47044999,43232160,90277159,3,0,1,8192,21,8426951478
8843,47052381,43224801,90277182,5,0,1,4608,25,9360381099
8844,47055441,32376018,79431459,2,0,0,512,19,8902438739
8845,47055549,43222278,90277827,3,0,1,7168,21,5924693146
8846,47069340,32050999,79120339,0,0,0,11776,8,6648353135
8847,47071510,43239320,90310830,9,0,1,10240,4,6614416208
8848,47077489,43233364,90310853,3,0,1,3072,21,4868629946
8849,47080100,43230776,90310876,0,0,1,3584,8,9058480571
8850,47081090,43229809,90310899,9,0,1,3072,4,288647986
8851,47099390,32456091,79555481,9,0,0,184320,4,6833391151
8852,47112651,43210834,90323485,5,0,1,9216,25,1500811796
8853,47126081,43199350,90325431,5,0,1,3072,25,8060185172
8854,47134580,32209351,79343931,1,0,0,50688,5,6927872162
8855,47135810,32232636,79368446,0,0,0,80384,8,5293350964
8856,47136440,32191239,79327679,6,0,0,24064,17,6656583525
8857,47143020,32251734,79394754,1,0,0,71168,5,9865062
8858,47149510,43181191,90330701,0,0,1,4096,8,6941437882
8859,47157300,32215739,79373039,0,0,0,14848,8,2350980393
8860,47160830,32625974,79786804,1,0,0,49152,5,10271320484
8861,47164820,32901128,80065948,7,0,0,23552,21,6831949950
8862,47164879,43167128,90332007,3,0,1,2048,21,3410162322
8863,47166130,43167503,90333633,0,0,1,2560,8,3216027043
8864,47167839,43168060,90335899,3,0,1,3584,21,703839162
8865,47176430,32424779,79601209,0,0,0,79360,8,8572418853
8866,47177560,32253697,79431257,1,0,0,54272,5,3765507344
8867,47180250,43156315,90336565,0,0,1,1024,8,708249503
8868,47183701,32144740,79328441,2,0,0,2048,19,1787316973
8869,47187451,32207982,79395433,2,0,0,2048,19,4771601023
8870,47193230,43143591,90336821,0,0,1,9216,8,899332197
8871,47193729,43144078,90337807,3,0,1,1536,21,1872020507
8872,47196140,32664506,79860646,6,0,0,33280,17,8273105022
8873,47201990,32914187,80116177,7,0,0,45056,21,426102094
8874,47204460,43135613,90340073,0,0,1,3584,8,4129892317
8875,47209900,32289398,79499298,0,0,0,18432,8,4265902613
8876,47234401,32203820,79438221,2,0,0,1024,19,8559968003
8877,47235240,43128255,90363495,0,0,1,1024,8,4574406064
8878,47239000,32453079,79692079,1,0,0,58880,5,3606444109
8879,47239720,43124339,90364059,0,0,1,10752,8,4209655899
8880,47246880,32190998,79437878,6,0,0,20992,17,559878026
8881,47250271,32376315,79626586,2,0,0,1024,19,4961240074
8882,47260170,32179322,79439492,7,0,0,4096,21,5301465716
8883,47279601,32165625,79445226,2,0,0,1536,19,8331540715
8884,47284180,43085769,90369949,0,0,1,4608,8,4681488460
8885,47308600,43063615,90372215,0,0,1,3584,8,6909558232
8886,47310710,32748039,80058749,1,0,0,202240,5,6028070576
8887,47311631,32594002,79905633,2,0,0,1536,19,3984985912
8888,47315270,32787156,80102426,7,0,0,97280,21,6408033196
8889,47317400,32434318,79751718,6,0,0,31232,17,103317408
8890,47317470,32396628,79714098,0,0,0,72192,8,2619760545
8891,47322559,43051602,90374161,3,0,1,3072,21,4174989658
8892,47322909,43054184,90377093,3,0,1,4608,21,9003816151
8893,47329761,32503063,79832824,2,0,0,1024,19,9148107777
8894,47331990,43045564,90377554,0,0,1,10240,8,10156036228
8895,47335560,32595235,79930795,6,0,0,4096,17,6709613331
8896,47354870,32762468,80117338,6,0,0,2048,17,7754958940
8897,47362921,32753770,80116691,2,0,0,1536,19,3510391466
8898,47364989,43012911,90377900,3,0,1,512,21,265151553
8899,47367449,43014317,90381766,3,0,1,6144,21,5803268911
8900,47372931,32289304,79662235,2,0,0,512,19,4435577963
8901,47373991,32419887,79793878,2,0,0,512,19,530394920
8902,47374051,32500864,79874915,2,0,0,1536,19,10218962186
8903,47376400,32417291,79793691,1,0,0,22528,5,1725556411
8904,47388580,42994812,90383392,2,0,1,2560,19,8415483775
8905,47401270,32202637,79603907,1,0,0,8704,5,9713749483
8906,47401640,32818958,80220598,6,0,0,91136,17,3225656866
8907,47409591,32512320,79921911,2,0,0,512,19,10243952336
8908,47410281,32314994,79725275,2,0,0,512,19,2534762395
8909,47437711,32556981,79994692,2,0,0,2048,19,2484022052
8910,47463330,42924195,90387525,2,0,1,3072,19,9921077688
8911,47466790,32687028,80153818,0,0,0,33280,8,4915358307
8912,47471670,32433472,79905142,7,0,0,23040,21,6929551775
8913,47473440,32359049,79832489,6,0,0,11776,17,3356311899
8914,47479430,32461318,79940748,1,0,0,14848,5,9166287652
8915,47499640,32848614,80348254,6,0,0,94208,17,1053946874
8916,47502180,32222890,79725070,0,0,0,24576,8,6417629932
8917,47502970,32418754,79921724,7,0,0,52736,21,3000341799
8918,47503590,32983180,80486770,0,0,0,39936,8,9958433935
8919,47511240,42882737,90393977,2,0,1,10240,19,4479139735
8920,47518170,42877292,90395462,2,0,1,15360,19,1476404768
8921,47519590,32309288,79828878,6,0,0,11776,17,991008548
8922,47525131,32652661,80177792,9,0,0,12288,4,6229299266
8923,47525911,33036741,80562652,2,0,0,512,19,4976637600
8924,47528761,32538302,80067063,2,0,0,3584,19,730830368
8925,47538491,32621775,80160266,2,0,0,1536,19,4159089175
8926,47541269,42869944,90411213,3,0,1,4608,21,8970559451
8927,47541760,32819059,80360819,6,0,0,23552,17,325936546
8928,47542731,32436521,79979252,2,0,0,512,19,6494149354
8929,47557800,32736120,80293920,7,0,0,15360,21,8300154855
8930,47564201,32675275,80239476,2,0,0,512,19,4670513184
8931,47575209,42840190,90415399,3,0,1,6656,21,10227745192
8932,47575650,42840415,90416065,2,0,1,1024,19,1493508170
8933,47582520,42836451,90418971,2,0,1,4608,19,8593800138
8934,47585200,42835077,90420277,9,0,1,2048,4,8575256847
8935,47588380,33147237,80735617,0,0,0,20480,8,2434442650
8936,47592290,32727237,80319527,7,0,0,83968,21,151795955
8937,47595549,42826003,90421552,3,0,1,512,21,8769164896
8938,47596150,32476613,80072763,6,0,0,7680,17,3870618343
8939,47601810,42823670,90425480,2,0,1,5632,19,322714297
8940,47605770,32925330,80531100,1,0,0,36352,5,9334368248
8941,47622640,32600633,80223273,1,0,0,8704,5,10543064256
8942,47627561,32737493,80365054,9,0,0,13824,4,9514212342
8943,47640211,32584200,80224411,2,0,0,1536,19,1471580935
8944,47658700,32689897,80348597,0,0,0,1024,8,5017593956
8945,47661640,32512385,80174025,1,0,0,41472,5,3203432397
8946,47664880,32624337,80289217,1,0,0,72704,5,7940235650
8947,47668451,32924595,80593046,2,0,0,512,19,3420901648
8948,47672670,32680942,80353612,6,0,0,16384,17,6700754110
8949,47681201,32542719,80223920,2,0,0,2048,19,8481827983
8950,47681600,32743636,80425236,0,0,0,12800,8,9797434252
8951,47686660,33173971,80860631,7,0,0,133632,21,333434047
8952,47695241,33040711,80735952,9,0,0,1024,4,1452296663
8953,47698830,32851645,80550475,6,0,0,63488,17,8402945395
8954,47699401,32726673,80426074,2,0,0,2048,19,4873267639
8955,47702540,32876280,80578820,0,0,0,51200,8,1193463366
8956,47709150,33058183,80767333,1,0,0,69120,5,8038372785
8957,47713681,32652020,80365701,2,0,0,2048,19,1373695182
8958,47714160,42714546,90428706,2,0,1,5120,19,841877846
8959,47716860,32803141,80520001,6,0,0,72192,17,6731556177
8960,47722550,32829254,80551804,1,0,0,3072,5,5667637029
8961,47731380,32713837,80445217,7,0,0,25600,21,8484170806
8962,47767371,32849213,80616584,2,0,0,1024,19,5752200723
8963,47771871,42907244,90679115,7,0,1,36352,21,1135355131
8964,47772879,42907107,90679986,3,0,1,12288,21,8118923522
8965,47777771,32783345,80561116,2,0,0,512,19,1148650431
8966,47779321,42956711,90736032,7,0,1,7680,21,5872431982
8967,47789920,32792511,80582431,1,0,0,11776,5,7638382028
8968,47798030,33149388,80947418,6,0,0,13824,17,9820929207
8969,47809310,42946186,90755496,4,0,1,2560,25,6602306578
8970,47813041,32673908,80486949,2,0,0,512,19,1079528810
8971,47821720,32893795,80715515,6,0,0,39936,17,3050572718
8972,47831101,43033641,90864742,7,0,1,87552,21,7099028413
8973,47837380,43079491,90916871,9,0,1,18944,4,9466612290
8974,47839660,32771023,80610683,1,0,0,23552,5,9673855190
8975,47840110,32846081,80686191,6,0,0,12288,17,10060126468
8976,47853461,32842036,80695497,2,0,0,512,19,8410389538
8977,47866471,32901665,80768136,2,0,0,2560,19,5724489257
8978,47871819,43047590,90919409,8,0,1,1024,1,6817433451
8979,47876921,32803374,80680295,2,0,0,3072,19,6686080490
8980,47883251,33201923,81085174,9,0,0,29184,4,8006537387
8981,47884461,32716812,80601273,9,0,0,1024,4,10209310257
8982,47898481,43048116,90946597,7,0,1,18944,21,2472338735
8983,47921230,32977537,80898767,9,0,0,65024,4,1704720927
8984,47925191,43103764,91028955,7,0,1,80896,21,5395750364
8985,47930551,43140002,91070553,7,0,1,18944,21,4113235748
8986,47930861,43152555,91083416,7,0,1,14848,21,2597694951
8987,47936030,33331259,81267289,7,0,0,175104,21,5421921885
8988,47937840,32882052,80819892,6,0,0,44544,17,3857321979
8989,47938431,32777598,80716029,2,0,0,1536,19,8022080257
8990,47948001,43261920,91209921,7,0,1,130048,21,9732878837
8991,47960250,43262927,91223177,2,0,1,22016,19,528806985
8992,47964310,43281862,91246172,2,0,1,3072,19,8269478145
8993,47965971,43287457,91253428,7,0,1,7680,21,7353811828
8994,47968581,33003184,80971765,2,0,0,512,19,5786137212
8995,47968900,33022624,80991524,1,0,0,37888,5,782468077
8996,47973051,43282643,91255694,7,0,1,3584,21,918461434
8997,47977120,32885117,80862237,1,0,0,5120,5,783854739
8998,47983690,43272350,91256040,2,0,1,512,19,4000648415
8999,47983969,43287666,91271635,8,0,1,31232,1,1181449843
9000,47992630,32873998,80866628,6,0,0,14336,17,4264043607
9001,47996891,32994812,80991703,2,0,0,512,19,2979349897
9002,48009550,43262751,91272301,4,0,1,1024,25,6995848208
9003,48010090,43264797,91274887,2,0,1,4096,19,3770162457
9004,48014361,32961033,80975394,2,0,0,2048,19,4061556235
9005,48014631,33136695,81151326,9,0,0,12800,4,9737838478
9006,48019670,33056589,81076259,9,0,0,72704,4,2341292609
9007,48022549,43253644,91276193,1,0,1,2048,5,8053452712
9008,48025069,43251790,91276859,8,0,1,1024,1,5886965101
9009,48031930,43245915,91277845,9,0,1,1536,4,9197967271
9010,48053111,33000973,81054084,9,0,0,142848,4,5922066581
9011,48055179,43224932,91280111,8,0,1,3584,1,6145920095
9012,48065881,32937463,81003344,2,0,0,1024,19,2402978685
9013,48069920,33095667,81165587,6,0,0,8192,17,3052993473
9014,48085330,33000023,81085353,9,0,0,512,4,10604500635
9015,48092670,33005529,81098199,1,0,0,25600,5,41520653
9016,48100020,32990348,81090368,9,0,0,16384,4,2285612402
9017,48109880,33170388,81280268,1,0,0,8704,5,8326422697
9018,48110249,43175149,91285398,8,0,1,16896,1,2518684698
9019,48116031,33011251,81127282,2,0,0,512,19,6285550606
9020,48118251,33063202,81181453,9,0,0,27136,4,7364906954
9021,48118780,43166956,91285736,9,0,1,512,4,8013838296
9022,48131620,43156728,91288348,0,0,1,4096,8,7921851322
9023,48132930,43158324,91291254,9,0,1,4608,4,1777553271
9024,48135149,43161251,91296400,8,0,1,8192,1,7697614147
9025,48139251,33065454,81204705,2,0,0,1024,19,8482340078
9026,48143971,33190405,81334376,2,0,0,2560,19,2113365922
9027,48151010,43145954,91296964,9,0,1,10752,4,6227283782
9028,48167811,33181430,81349241,2,0,0,512,19,6816500494
9029,48180600,33087960,81268560,1,0,0,4096,5,461577079
9030,48184799,43128154,91312953,8,0,1,12288,1,5914847381
9031,48188031,33118043,81306074,2,0,0,1536,19,4637623990
9032,48195189,43122431,91317620,1,0,1,2560,5,264686254
9033,48195840,33133739,81329579,9,0,0,7680,4,2564458506
9034,48205521,33095633,81301154,2,0,0,512,19,8379712182
9035,48208960,43109646,91318606,9,0,1,1536,4,7430302438
9036,48227179,43092733,91319912,1,0,1,2048,5,10606443524
9037,48245509,43075709,91321218,8,0,1,2048,1,166997528
9038,48247450,33411421,81658871,1,0,0,56320,5,6465924368
9039,48258129,43064075,91322204,8,0,1,1536,1,9910725798
9040,48262239,43061591,91323830,8,0,1,2560,1,9098443044
9041,48264440,33677355,81941795,6,0,0,39936,17,6536832256
9042,48273900,43052516,91326416,9,0,1,4096,4,4601708157
9043,48275061,33810710,82085771,9,0,0,56320,4,2800076576
9044,48275159,43051603,91326762,1,0,1,512,5,7306397672
9045,48279181,33181179,81460360,9,0,0,19456,4,4157282505
9046,48287569,43040819,91328388,3,0,1,2560,21,5924791290
9047,48296570,43036004,91332574,9,0,1,6656,4,202969089
9048,48296830,33219071,81515901,6,0,0,13312,17,7588746299
9049,48302460,33336220,81638680,6,0,0,9216,17,8757202275
9050,48316540,33437670,81754210,6,0,0,39424,17,694143260
9051,48320040,33405393,81725433,9,0,0,68608,4,4050390247
9052,48327610,33255541,81583151,9,0,0,47104,4,5989106888
9053,48332570,33436483,81769053,1,0,0,48640,5,2127628612
9054,48332639,43001561,91334200,1,0,1,2560,5,2726680407
9055,48333409,43001457,91334866,8,0,1,1024,1,5022076309
9056,48338951,33245182,81584133,2,0,0,1024,19,1922947761
9057,48341120,33850121,82191241,1,0,0,54272,5,2939139290
9058,48348239,42992016,91340255,1,0,1,17408,5,127405209
9059,48368081,33517454,81885535,9,0,0,23552,4,7697219442
9060,48371230,33474643,81845873,6,0,0,30720,17,6147768778
9061,48371380,33212418,81583798,6,0,0,2048,17,922752026
9062,48374740,33628094,82002834,1,0,0,1024,5,2972806692
9063,48374780,33519982,81894762,1,0,0,30208,5,265000317
9064,48375960,33213289,81589249,1,0,0,14336,5,7991369395
9065,48381760,42959161,91340921,9,0,1,1024,4,7250262144
9066,48383309,42958585,91341894,1,0,1,12800,5,2006136550
9067,48386110,33778480,82164590,1,0,0,113152,5,929678
9068,48386451,33205042,81591493,2,0,0,1536,19,7240119229
9069,48392069,42951771,91343840,1,0,1,3072,5,3036429151
9070,48392149,42953774,91345923,1,0,1,2560,5,10133196237
9071,48396840,42951989,91348829,9,0,1,4608,4,3578170558
9072,48416110,33386367,81802477,6,0,0,2048,17,10177542307
9073,48423410,33246528,81669938,1,0,0,8704,5,8321470855
9074,48442309,42907826,91350135,8,0,1,2048,1,4979340637
9075,48442580,42910781,91353361,9,0,1,5120,4,5231900673
9076,48446789,42928018,91374807,1,0,1,4096,5,5171248301
9077,48486960,33619767,82106727,6,0,0,43008,17,3432710677
9078,48487381,33574141,82061522,9,0,0,94720,4,2777507341
9079,48488321,33729305,82217626,2,0,0,512,19,8303134244
9080,48497101,33501073,81998174,9,0,0,48128,4,3963616586
9081,48508870,33708001,82216871,1,0,0,83456,5,1343765031
9082,48514159,42860994,91375153,8,0,1,512,1,3327277869
9083,48514800,42861979,91376779,9,0,1,2560,4,3362659808
9084,48520069,42858016,91378085,8,0,1,2048,1,2996822971
9085,48521591,33567346,82088937,9,0,0,7680,4,3162092387
9086,48532500,33536065,82068565,6,0,0,23040,17,2102036431
9087,48532521,33448493,81981014,9,0,0,11776,4,6474387622
9088,48532939,42845492,91378431,1,0,1,512,5,1513609222
9089,48537120,33556270,82093390,6,0,0,14336,17,5781961973
9090,48545571,33541003,82086574,2,0,0,2560,19,3753821945
9091,48545650,42833767,91379417,9,0,1,1536,4,8396576500
9092,48548569,42832833,91381402,8,0,1,12288,1,3567202540
9093,48559130,42822631,91381761,9,0,1,9728,4,9730896842
9094,48559380,33721619,82280999,6,0,0,35840,17,5910091883
9095,48593769,42789298,91383067,1,0,1,2048,5,1438920640
9096,48594190,33383142,81977332,5,0,0,1536,25,3236848834
9097,48595981,33349666,81945647,2,0,0,1024,19,2789524959
9098,48602630,33420180,82022810,5,0,0,512,25,785855415
9099,48604669,42786263,91390932,1,0,1,4096,5,6599953459
9100,48604921,33396199,82001120,2,0,0,1024,19,9972426671
9101,48616431,33477169,82093600,2,0,0,512,19,8143745508
9102,48617560,33794526,82412086,6,0,0,126464,17,1757466150
9103,48628859,42762739,91391598,1,0,1,11264,5,8330241956
9104,48654101,33845713,82499814,9,0,0,56320,4,6512153618
9105,48661120,42740213,91401333,9,0,1,5120,4,1857849457
9106,48664580,33573843,82238423,5,0,0,512,25,6972743597
9107,48681451,33535996,82217447,2,0,0,1536,19,5479334669
9108,48688850,42713789,91402639,9,0,1,2048,4,7164826266
9109,48692041,33499379,82191420,2,0,0,512,19,10549927277
9110,48698180,42707985,91406165,9,0,1,14848,4,7713078039
9111,48698700,33608989,82307689,1,0,0,25088,5,252517658
9112,48703790,42713835,91417625,9,0,1,3072,4,7982625253
9113,48703831,33762942,82466773,2,0,0,512,19,20841039
9114,48706910,42713531,91420441,9,0,1,10752,4,1293706236
9115,48722100,33692083,82414183,1,0,0,6656,5,483325415
9116,48725371,33805772,82531143,9,0,0,85504,4,4848619602
9117,48727140,42718971,91446111,9,0,1,7168,4,10187035879
9118,48734801,34049720,82784521,9,0,0,31232,4,522195562
9119,48735269,42712148,91447417,1,0,1,2048,5,2226414109
9120,48740380,42713169,91453549,9,0,1,9728,4,5660157326
9121,48746911,33607200,82354111,2,0,0,512,19,7004946654
9122,48751080,33786170,82537250,6,0,0,19968,17,9579801689
9123,48754320,42699588,91453908,9,0,1,9728,4,265306714
9124,48757190,33725323,82482513,5,0,0,512,25,10736171913
9125,48759230,33915595,82674825,6,0,0,36864,17,6016258146
9126,48773880,33640513,82414393,5,0,0,512,25,7542487604
9127,48776340,42689211,91465551,9,0,1,9728,4,7215841035
9128,48782900,33880670,82663570,1,0,0,35328,5,7108213482
9129,48786179,42680358,91466537,1,0,1,1536,5,2324800754
9130,48786699,42700066,91486765,1,0,1,11264,5,10478736266
9131,48789360,33529727,82319087,5,0,0,5120,25,7068885980
9132,48789600,42701671,91491271,9,0,1,7168,4,2811876815
9133,48796890,42698619,91495509,9,0,1,5632,4,57262995
9134,48801440,33663953,82465393,5,0,0,1024,25,191657288
9135,48809320,33728265,82537585,5,0,0,1024,25,9026824189
9136,48810330,33737886,82548216,6,0,0,34816,17,1272125385
9137,48815990,42686662,91502652,9,0,1,2560,4,8113487552
9138,48816271,33860986,82677257,9,0,0,6656,4,7537986780
9139,48838069,42668482,91506551,1,0,1,10752,5,2895692648
9140,48841981,34103236,82945217,9,0,0,150016,4,4632458257
9141,48850270,33900125,82750395,5,0,0,1024,25,1878689008
9142,48854330,33895730,82750060,6,0,0,30720,17,1286528984
9143,48868010,33752437,82620447,1,0,0,18432,5,467218988
9144,48868390,42639416,91507806,9,0,1,1536,4,9478377037
9145,48870171,34015366,82885537,2,0,0,1024,19,10274005739
9146,48893131,33739022,82632153,9,0,0,25600,4,7395290989
9147,48900290,42607862,91508152,9,0,1,512,4,3770713142
9148,48903140,33772020,82675160,5,0,0,1024,25,2513597708
9149,48903841,33644562,82548403,2,0,0,512,19,6390434639
9150,48904159,42606899,91511058,1,0,1,4608,5,6454707380
9151,48906239,42606125,91512364,1,0,1,2048,5,7813322555
9152,48922920,33851993,82774913,1,0,0,27136,5,2360713861
9153,48931889,42602724,91534613,1,0,1,11776,5,3657941482
9154,48934089,42602150,91536239,1,0,1,2560,5,7886805418
9155,48936709,42626228,91562937,1,0,1,35328,5,6247614480
9156,48938539,42640823,91579362,1,0,1,2048,5,5525423898
9157,48943440,34121924,83065364,1,0,0,39424,5,3014509001
9158,48956320,33865401,82821721,5,0,0,512,25,6567447021
9159,48963160,42620388,91583548,9,0,1,6656,4,5773606820
9160,48970079,42616075,91586154,1,0,1,1536,5,8582160106
9161,48990300,33740816,82731116,5,0,0,1024,25,7028721329
9162,48991310,33739471,82730781,1,0,0,21504,5,7210364973
9163,49003041,33796358,82799399,2,0,0,512,19,9774038700
9164,49007501,34134057,83141558,2,0,0,1024,19,2644669920
9165,49010049,42576771,91586820,1,0,1,1024,5,4994583829
9166,49015300,33716151,82731451,5,0,0,1024,25,9526660115
9167,49018850,33766638,82785488,6,0,0,3072,17,5525100705
9168,49021400,33710432,82731832,5,0,0,1024,25,1231999490
9169,49021641,33811778,82833419,2,0,0,512,19,9997433406
9170,49031750,33864843,82896593,1,0,0,1024,5,2783519781
9171,49036160,42551326,91587486,9,0,1,1024,4,8816227539
9172,49042289,42547463,91589752,1,0,1,3584,5,460057923
9173,49049321,34136280,83185601,9,0,0,62464,4,4723494053
9174,49070470,42526054,91596524,9,0,1,10752,4,7505489424
9175,49075370,33757700,82833070,6,0,0,1536,17,1548812586
9176,49078360,33722575,82800935,5,0,0,512,25,7404500646
9177,49082790,33802355,82885145,1,0,0,17920,5,9930026315
9178,49083600,42516150,91599750,9,0,1,5120,4,7658243195
9179,49084900,34050365,83135265,1,0,0,18944,5,9605332557
9180,49092141,34108871,83201012,9,0,0,15872,4,4581751186
9181,49107781,33750088,82857869,9,0,0,29696,4,7568103000
9182,49115340,34115709,83231049,1,0,0,2048,5,6920820027
9183,49116451,33893909,83010360,9,0,0,22016,4,8958888999
9184,49121760,34128237,83249997,1,0,0,47104,5,1156073720
9185,49132750,33836573,82969323,1,0,0,28160,5,7426957785
9186,49132920,42468456,91601376,9,0,1,2560,4,1060053531
9187,49135350,42477373,91612723,2,0,1,11776,19,1053265612
9188,49138600,34057522,83196122,1,0,0,33792,5,4077871228
9189,49139960,34141529,83281489,6,0,0,22528,17,7809976052
9190,49141661,33941605,83083266,9,0,0,3072,4,1785025062
9191,49154391,42458998,91613389,5,0,1,1024,25,7471207276
9192,49163820,33953672,83117492,5,0,0,3584,25,7592852672
9193,49165810,42450165,91615975,9,0,1,4096,4,8846606961
9194,49191390,42425571,91616961,9,0,1,1536,4,4790868957
9195,49191880,33755544,82947424,1,0,0,7168,5,9582567128
9196,49201130,42418097,91619227,9,0,1,3584,4,10123238868
9197,49211411,34149453,83360864,2,0,0,2048,19,8615385573
9198,49211760,34370926,83582686,1,0,0,40960,5,6216192074
9199,49212741,34201889,83414630,9,0,0,41984,4,2989123907
9200,49218970,34011237,83230207,6,0,0,95744,17,2142583404
9201,49219751,34010635,83230386,2,0,0,512,19,7550897629
9202,49227711,33785173,83012884,2,0,0,1536,19,981963429
9203,49228310,34036661,83264971,5,0,0,1024,25,8950845043
9204,49235021,33996542,83231563,2,0,0,1024,19,3199320786
9205,49240431,33990797,83231228,2,0,0,512,19,1902192217
9206,49251540,33915006,83166546,1,0,0,9216,5,1343493408
9207,49252081,34102327,83354408,2,0,0,1024,19,7050923004
9208,49272891,33912889,83185780,2,0,0,512,19,7971022610
9209,49280840,33829020,83109860,1,0,0,13824,5,2328279481
9210,49284781,33739465,83024246,9,0,0,12800,4,3921007703
9211,49295580,33845617,83141197,5,0,0,1024,25,7989089047
9212,49303991,33643635,82947626,2,0,0,512,19,8392687731
9213,49319010,33967651,83286661,5,0,0,512,25,1997043808
9214,49323141,34243487,83566628,9,0,0,236544,4,6309546202
9215,49326109,42296344,91622453,6,0,1,5120,17,3896583692
9216,49330040,34128602,83458642,5,0,0,512,25,1444203042
9217,49334121,42291558,91625679,5,0,1,5120,25,6062948740
9218,49341339,42285006,91626345,6,0,1,11264,17,2681992583
9219,49345520,34087907,83433427,6,0,0,39424,17,5620476814
9220,49346349,42281622,91627971,1,0,1,2560,5,8107089799
9221,49365091,34255322,83620413,9,0,0,56320,4,5353995390
9222,49371340,34344443,83715783,1,0,0,15360,5,3345966952
9223,49389420,34031964,83421384,6,0,0,7680,17,8797458207
9224,49401011,34169164,83570175,9,0,0,1024,4,1923822143
9225,49407211,34162606,83569817,9,0,0,10240,4,692754149
9226,49413969,42214988,91628957,6,0,1,1536,17,6480194761
9227,49417891,34029871,83447762,9,0,0,15872,4,1409688385
9228,49422210,34041423,83463633,1,0,0,8192,5,1631317611
9229,49422749,42209114,91631863,6,0,1,4608,17,1445565112
9230,49427990,34282755,83710745,1,0,0,46592,5,4395472749
9231,49456080,34218876,83674956,5,0,0,1536,25,7727459566
9232,49473839,42159330,91633169,6,0,1,2048,17,9448821306
9233,49489061,34426297,83915358,9,0,0,87040,4,7112373448
9234,49491450,42146545,91637995,0,0,1,7680,8,3082691837
9235,49502220,33916801,83419021,1,0,0,14336,5,10606561793
9236,49506000,34259502,83765502,6,0,0,13824,17,10016943900
9237,49522750,34151715,83674465,1,0,0,12800,5,1961471302
9238,49544570,42101220,91645790,0,0,1,9216,8,10432184048
9239,49546690,42106715,91653405,0,0,1,5632,8,683026368
9240,49559480,34111062,83670542,1,0,0,132608,5,4254471615
9241,49560540,34029213,83589753,6,0,0,23040,17,1943402744
9242,49569870,34236731,83806601,1,0,0,86016,5,7054318023
9243,49580100,42086232,91666332,0,0,1,5632,8,5398993847
9244,49603660,34273736,83877396,1,0,0,33792,5,3140899049
9245,49605950,34449566,84055516,6,0,0,17920,17,9830068691
9246,49621029,42049169,91670198,8,0,1,6144,1,9807718746
9247,49631870,34104130,83736000,6,0,0,30720,17,7298043896
9248,49643730,34371736,84015466,1,0,0,99328,5,3081264772
9249,49648090,34436837,84084927,1,0,0,57856,5,6227897598
9250,49649530,42021898,91671428,0,0,1,11776,8,6219433704
9251,49655870,34260212,83916082,1,0,0,512,5,3683963582
9252,49657459,42014635,91672094,6,0,1,1024,17,4912980814
9253,49659789,42014571,91674360,6,0,1,3584,17,10328992933
9254,49661240,33960132,83621372,6,0,0,3072,17,10558102064
9255,49663249,42013697,91676946,6,0,1,4096,17,1050192636
9256,49663559,42015973,91679532,8,0,1,4096,1,1481416531
9257,49686179,41993699,91679878,8,0,1,512,1,2861698210
9258,49688999,41991865,91680864,6,0,1,1536,17,43899123
9259,49691090,34024872,83715962,1,0,0,512,5,3808545016
9260,49691200,41991930,91683130,0,0,1,3584,8,5008098008
9261,49692400,34018680,83711080,5,0,0,1024,25,10321142909
9262,49699200,34216703,83915903,5,0,0,1536,25,6986902504
9263,49700350,41983126,91683476,0,0,1,512,8,7640519659
9264,49707101,34247660,83954761,9,0,0,12288,4,7035180194
9265,49710919,41975783,91686702,8,0,1,5120,1,6120292134
9266,49721940,41971534,91693474,0,0,1,10752,8,1376536723
9267,49723709,41971711,91695420,3,0,1,3072,21,8507311261
9268,49726710,41969376,91696086,0,0,1,1024,8,5203752027
9269,49735689,41962663,91698352,3,0,1,3584,21,1364087199
9270,49744030,34062929,83806959,5,0,0,1024,25,4190375016
9271,49751119,41947579,91698698,3,0,1,512,21,3693724862
9272,49753999,41948245,91702244,3,0,1,5632,21,9742115192
9273,49762450,41949773,91712223,0,0,1,14848,8,9233966991
9274,49777240,34111567,83888807,6,0,0,37376,17,2107863169
9275,49778139,41934340,91712479,3,0,1,9216,21,7220397446
9276,49788649,41928904,91717553,3,0,1,2048,21,8790692075
9277,49788739,41930760,91719499,8,0,1,3072,1,3904362112
9278,49795080,41929245,91724325,0,0,1,7680,8,4430530190
9279,49798820,41941571,91740391,0,0,1,12288,8,5593538219
9280,49803030,34153063,83956093,6,0,0,1536,17,7360931498
9281,49803329,41939535,91742864,8,0,1,1024,1,5539546682
9282,49804660,34319814,84124474,6,0,0,41472,17,3198557861
9283,49812690,41952030,91764720,0,0,1,512,8,4658917272
9284,49813720,41954226,91767946,0,0,1,5120,8,3057659518
9285,49814181,34484868,84299049,9,0,0,45056,4,8246014550
9286,49822979,41948513,91771492,8,0,1,5632,1,6880072418
9287,49825271,34314519,84139790,9,0,0,6144,4,6898710454
9288,49834769,41938349,91773118,3,0,1,2560,21,8654215866
9289,49842429,41932981,91775410,3,0,1,3584,21,5857670424
9290,49846839,41934575,91781414,6,0,1,20480,17,9741997232
9291,49853980,34256776,84110756,6,0,0,12800,17,3222704271
9292,49856560,41930000,91786560,0,0,1,8192,8,8659861963
9293,49857749,41930757,91788506,3,0,1,3072,21,10580631373
9294,49866249,41922603,91788852,3,0,1,512,21,8670539516
9295,49867540,41924764,91792304,0,0,1,15872,8,8020847522
9296,49877689,41914961,91792650,3,0,1,512,21,4270746891
9297,49882550,34306065,84188615,5,0,0,1536,25,5008581878
9298,49890439,41903837,91794276,8,0,1,2560,1,174436660
9299,49893269,41901673,91794942,3,0,1,11264,21,4591305430
9300,49905940,41895464,91801404,9,0,1,5120,4,5509404287
9301,49906430,41895320,91801750,0,0,1,512,8,418468986
9302,49910110,41894226,91804336,0,0,1,4096,8,9571784071
9303,49914489,41890001,91804490,3,0,1,8704,21,9893967356
9304,49917930,34182776,84100706,1,0,0,512,5,9591942154
9305,49918159,41912604,91830763,6,0,1,4608,17,10057485681
9306,49918429,41914920,91833349,6,0,1,4096,17,2416352355
9307,49919130,34166288,84085418,1,0,0,1536,5,8854221789
9308,49921750,41911945,91833695,9,0,1,512,4,9557812201
9309,49925929,41908752,91834681,1,0,1,1536,5,6285459373
9310,49930600,34260527,84191127,5,0,0,2048,25,9590040225
9311,49934599,41902668,91837267,6,0,1,4096,17,9830676384
9312,49935779,41902794,91838573,8,0,1,2048,1,743472141
9313,49938669,41901210,91839879,6,0,1,2048,17,213496854
9314,49941361,34490340,84431701,9,0,0,117248,4,2938920287
9315,49942049,41898816,91840865,1,0,1,1536,5,6666560717
9316,49945019,41896858,91841877,8,0,1,11776,1,2009814825
9317,49946880,34362932,84309812,5,0,0,512,25,2733571871
9318,49947560,34368398,84315958,1,0,0,512,5,367650826
9319,49947580,34421458,84369038,6,0,0,4096,17,6989563735
9320,49950580,34275002,84225582,1,0,0,2048,5,8189141201
9321,49952250,41890933,91843183,0,0,1,2048,8,8744735796
9322,49954280,41896157,91850437,0,0,1,512,8,3385507136
9323,49956481,34740483,84696964,9,0,0,122368,4,1844180128
9324,49956660,41894238,91850898,0,0,1,10240,8,3601369575
9325,49957869,41912039,91869908,3,0,1,512,21,1049851473
9326,49958170,41914324,91872494,0,0,1,4096,8,6991011805
9327,49970041,34520646,84490687,9,0,0,77824,4,6531362414
9328,49970449,41902391,91872840,6,0,1,512,17,7093648587
9329,49972039,41904027,91876066,8,0,1,5120,1,9689792941
9330,49972089,41905631,91877720,8,0,1,11264,1,3893435715
9331,49972720,41921810,91894530,0,0,1,6656,8,8825103263
9332,49977759,41919677,91897436,6,0,1,4608,17,8310785642
9333,49980259,41918163,91898422,3,0,1,1536,21,3091718418
9334,49984539,41917109,91901648,8,0,1,5120,1,2032172948
9335,49985079,41933178,91918257,1,0,1,12800,5,4528557658
9336,49986619,41942630,91929249,6,0,1,5632,17,9111400414
9337,49987270,34829065,84816335,6,0,0,112640,17,8941425648
9338,49987420,34626646,84614066,6,0,0,13312,17,9621714734
9339,49988810,34759146,84747956,6,0,0,7680,17,8110946425
9340,49991380,41941125,91932505,9,0,1,512,4,5163543576
9341,49998210,41935678,91933888,9,0,1,14848,4,5598867135
9342,50001420,41940867,91942287,0,0,1,7680,8,5832915073
9343,50002970,34836144,84839114,1,0,0,1536,5,6815942585
9344,50005779,41936854,91942633,6,0,1,512,17,7196888270
9345,50008570,34446671,84455241,1,0,0,512,5,10008331884
9346,50012470,41943608,91956078,0,0,1,7168,8,8786597327
9347,50021480,34503454,84524934,1,0,0,1024,5,9957196853
9348,50023430,41937820,91961250,9,0,1,8192,4,838204829
9349,50028039,41934197,91962236,1,0,1,1536,5,8934700861
9350,50032940,41933802,91966742,0,0,1,7168,8,8694735329
9351,50037799,41934128,91971927,6,0,1,16384,17,1845078
9352,50039289,41938623,91977912,1,0,1,5120,5,6139122578
9353,50043619,41938214,91981833,8,0,1,512,1,4803550098
9354,50044660,34709728,84754388,1,0,0,3584,5,3086195069
9355,50049770,34767419,84817189,5,0,0,1536,25,10493249953
9356,50050499,41950275,92000774,8,0,1,19968,1,2064202224
9357,50057001,34548675,84605676,9,0,0,70656,4,6026739829
9358,50059821,34652929,84712750,9,0,0,47616,4,7606543710
9359,50077739,41935395,92013134,8,0,1,3072,1,894090115
9360,50086109,41928331,92014440,3,0,1,2048,21,6631013208
9361,50087791,34795369,84883160,9,0,0,18944,4,1699105927
9362,50089240,41936863,92026103,9,0,1,3584,4,698547810
9363,50092900,41940295,92033195,9,0,1,11264,4,9737281581
9364,50094399,41939782,92034181,8,0,1,1536,1,2829367291
9365,50094829,41940658,92035487,8,0,1,2048,1,8141728701
9366,50096989,41946935,92043924,3,0,1,21504,21,2893401787
9367,50105460,34724153,84829613,5,0,0,1024,25,7319304504
9368,50107929,41936661,92044590,3,0,1,1024,21,1468057786
9369,50111210,41935966,92047176,0,0,1,4096,8,5119110895
9370,50115749,41934653,92050402,1,0,1,5120,5,4657130753
9371,50118640,34765167,84883807,1,0,0,2048,5,7542146968
9372,50120609,41930139,92050748,6,0,1,512,17,1525007936
9373,50138121,34922494,85060615,9,0,0,15872,4,4416481368
9374,50147689,41903405,92051094,6,0,1,512,17,1655562918
9375,50150369,41902031,92052400,1,0,1,2048,5,807510094
9376,50151990,34931973,85083963,6,0,0,12800,17,2399730292
9377,50154511,35209165,85363676,9,0,0,75776,4,6943186106
9378,50159980,34665883,84825863,1,0,0,512,5,9443084963
9379,50162300,34712385,84874685,5,0,0,512,25,10479827488
9380,50164660,41905143,92069803,0,0,1,21504,8,3166423836
9381,50214990,41860945,92075935,0,0,1,9728,8,2452951284
9382,50215289,41864090,92079379,1,0,1,3584,5,4019602395
9383,50217180,34845333,85062513,6,0,0,512,17,9925611518
9384,50220630,41875722,92096352,0,0,1,5120,8,9216569143
9385,50227090,41872168,92099258,0,0,1,4608,8,8457253252
9386,50227270,34893473,85120743,6,0,0,18432,17,2902725015
9387,50228130,35007852,85235982,1,0,0,512,5,2315321077
9388,50230030,41877034,92107064,0,0,1,5632,8,1820878379
9389,50231120,41879170,92110290,9,0,1,5120,4,3514631519
9390,50245670,41865491,92111161,0,0,1,12288,8,9111512210
9391,50253220,34750716,85003936,1,0,0,1536,5,9763073111
9392,50261000,35030445,85291445,6,0,0,70656,17,10227380575
9393,50264740,34551820,84816560,1,0,0,512,5,425883984
9394,50277980,34592050,84870030,1,0,0,512,5,4634232584
9395,50287220,34710416,84997636,1,0,0,1024,5,8036620613
9396,50305520,41806627,92112147,9,0,1,1536,4,6613080150
9397,50311260,41803153,92114413,9,0,1,3584,4,8361693564
9398,50319561,34903293,85222854,9,0,0,31744,4,4015040032
9399,50325530,41791321,92116851,0,0,1,1024,8,355139692
9400,50325930,41803166,92129096,9,0,1,27136,4,4015656982
9401,50333980,41806061,92140041,9,0,1,5632,4,6907611574
9402,50335040,41808227,92143267,9,0,1,5120,4,9738824433
9403,50335890,41808043,92143933,9,0,1,11264,4,3781820518
9404,50337130,34635134,84972264,6,0,0,30208,17,4059446996
9405,50347581,34708175,85055756,9,0,0,17408,4,3996585141
9406,50363010,41784112,92147122,0,0,1,4096,8,1837633230
9407,50367290,34865776,85233066,5,0,0,1024,25,2029810144
9408,50372740,34574635,84947375,5,0,0,1024,25,1259908899
9409,50385040,41774682,92159722,0,0,1,4608,8,9446154368
9410,50400520,34772026,85172546,6,0,0,21504,17,5142043056
9411,50402130,41759858,92161988,9,0,1,3584,4,2134509360
9412,50406650,34737115,85143765,6,0,0,28160,17,9713951974
9413,50416921,34627161,85044082,9,0,0,6144,4,4974780223
9414,50438300,41724252,92162552,0,0,1,10752,8,9370989626
9415,50439250,41727168,92166418,0,0,1,6144,8,1995681777
9416,50441870,41724894,92166764,9,0,1,512,4,4143053702
9417,50444770,41722660,92167430,0,0,1,11264,8,3504588230
9418,50447660,34687494,85135154,6,0,0,39936,17,3357247398
9419,50448320,34915847,85364167,1,0,0,1536,5,2624297934
9420,50455360,41717224,92172584,9,0,1,2048,4,2258358766
9421,50462950,41709980,92172930,9,0,1,512,4,215700061
9422,50473820,34634331,85108151,5,0,0,2048,25,5413221255
9423,50474850,34734470,85209320,1,0,0,1536,5,4197218623
9424,50495790,34524822,85020612,1,0,0,1024,5,4220831795
9425,50519519,41653770,92173289,6,0,1,9728,17,2266479947
9426,50523610,41652265,92175875,9,0,1,4096,4,8234467671
9427,50527090,34986895,85513985,5,0,0,4096,25,8726062833
9428,50528769,41651612,92180381,1,0,1,7168,5,5756474471
9429,50535539,41648068,92183607,1,0,1,5120,5,2247363636
9430,50539150,41645763,92184913,9,0,1,2048,4,4826531330
9431,50547469,41641950,92189419,1,0,1,7168,5,10331364288
9432,50550549,41646273,92196822,1,0,1,10240,5,1647382065
9433,50559630,41645273,92204903,9,0,1,1024,4,10255220229
9434,50561050,41645838,92206888,0,0,1,12288,8,10297187798
9435,50569619,41664052,92233671,1,0,1,9728,5,3876147804
9436,50571629,41664628,92236257,6,0,1,4096,17,7509033824
9437,50573559,41663044,92236603,6,0,1,512,17,538598660
9438,50592291,35040373,85632664,9,0,0,19968,4,3651720145
9439,50597610,41639352,92236962,9,0,1,9728,4,9555536219
9440,50601569,41635752,92237321,1,0,1,9728,5,9513387568
9441,50602019,41638848,92240867,1,0,1,5632,5,2786232198
9442,50626080,41620255,92246335,9,0,1,2560,4,10112347341
9443,50628550,34438727,85067277,8,0,0,1024,1,6414159877
9444,50632631,34637263,85269894,9,0,0,56832,4,4651100261
9445,50644071,41603890,92247961,5,0,1,2560,25,5044898546
9446,50644090,41608697,92252787,6,0,1,7680,17,7345161292
9447,50647939,41609034,92256973,1,0,1,6656,5,5550665290
9448,50651790,34462355,85114145,1,0,0,1024,5,136210987
9449,50666450,34454628,85121078,5,0,0,1024,25,6736144548
9450,50666701,34542128,85208829,9,0,0,68608,4,10599291900
9451,50671580,34852944,85524524,5,0,0,1536,25,8532906949
9452,50676999,41581280,92258279,6,0,1,2048,17,8909945530
9453,50685889,41576576,92262465,1,0,1,6656,5,1582101292
9454,50692120,41582103,92274223,9,0,1,8192,4,3606341460
9455,50698691,34799278,85497969,9,0,0,10752,4,7618759605
9456,50699530,41577599,92277129,9,0,1,4608,4,2297398033
9457,50700340,41583248,92283588,0,0,1,15360,8,5077901914
9458,50706469,41607931,92314400,6,0,1,6656,17,6947495731
9459,50709970,41607336,92317306,4,0,1,4608,25,10538115928
9460,50716520,41604012,92320532,9,0,1,5120,4,5228781518
9461,50717479,41604065,92321544,1,0,1,11776,5,7242307516
9462,50719591,34747652,85467243,9,0,0,16896,4,8251980704
9463,50722760,34795340,85518100,6,0,0,3584,17,6721945918
9464,50728900,41594078,92322978,9,0,1,1536,4,10609236453
9465,50738361,41602236,92340597,5,0,1,1536,25,453783966
9466,50741051,35022725,85763776,9,0,0,90112,4,9510259362
9467,50745520,34744130,85489650,1,0,0,512,5,5145770031
9468,50746130,34752330,85498460,1,0,0,1536,5,9094816792
9469,50748850,34561236,85310086,1,0,0,2560,5,4907162198
9470,50751060,35026646,85777706,6,0,0,45568,17,7746017484
9471,50767880,34836522,85604402,5,0,0,2560,25,7319984532
9472,50768961,41571982,92340943,5,0,1,512,25,724068823
9473,50770871,41572338,92343209,5,0,1,3584,25,8552983544
9474,50779920,34924922,85704842,5,0,0,512,25,9529304013
9475,50793910,34800314,85594224,6,0,0,33280,17,10274622737
9476,50805171,41539344,92344515,5,0,1,2048,25,10202765378
9477,50813101,41533360,92346461,5,0,1,3072,25,229713841
9478,50814460,35035665,85850125,5,0,0,16384,25,4774809651
9479,50815099,41531708,92346807,6,0,1,512,17,10022954569
9480,50815511,34882733,85698244,9,0,0,48128,4,9929025100
9481,50819320,35170104,85989424,5,0,0,137216,25,2313803125
9482,50824251,41527702,92351953,5,0,1,8192,25,3337962654
9483,50828389,41523923,92352312,1,0,1,9728,5,6212663035
9484,50831000,35172191,86003191,6,0,0,45056,17,2861224853
9485,50831200,34614128,85445328,5,0,0,21504,25,1196001093
9486,50831729,41523546,92355275,1,0,1,512,5,108791757
9487,50844249,41522240,92366489,6,0,1,5632,17,2170018457
9488,50847170,41520945,92368115,9,0,1,2560,4,2789246034
9489,50859040,34670428,85529468,6,0,0,7680,17,4600712924
9490,50862640,41509661,92372301,9,0,1,6656,4,6949051136
9491,50865471,35078488,85943959,9,0,0,71168,4,1969131084
9492,50872079,41501298,92373377,6,0,1,13312,17,4614441281
9493,50892330,34671251,85563581,1,0,0,512,5,1880110330
9494,50897770,34582681,85480451,5,0,0,1024,25,5840592360
9495,50914310,35547769,86462079,6,0,0,12288,17,8633573097
9496,50927341,35262474,86189815,9,0,0,127488,4,9870076217
9497,50928090,35201005,86129095,1,0,0,1024,5,8929782332
9498,50930150,34934989,85865139,1,0,0,2560,5,1667332276
9499,50951119,41433378,92384497,1,0,1,1024,5,2299399146
9500,50956340,35095537,86051877,6,0,0,19456,17,7176962973
9501,50969511,35287343,86256854,9,0,0,142336,4,5212601368
9502,50970600,35327961,86298561,6,0,0,6656,17,3130231553
9503,50997821,34618616,85616437,9,0,0,39424,4,7542050391
9504,51002790,34825964,85828754,6,0,0,33792,17,328624075
9505,51045881,41338872,92384753,5,0,1,9216,25,318143002
9506,51050000,35365196,86415196,5,0,0,60928,25,3661867947
9507,51054150,34502584,85556734,5,0,0,13312,25,10163479845
9508,51060090,34962780,86022870,5,0,0,64512,25,2375751779
9509,51067021,35219630,86286651,9,0,0,28672,4,2543394413
9510,51073001,34590404,85663405,9,0,0,6144,4,796916593
9511,51077560,34836578,85914138,6,0,0,36352,17,80805101
9512,51102900,34734132,85837032,6,0,0,11264,17,9205744634
9513,51104580,34512972,85617552,6,0,0,3584,17,10292337792
9514,51106031,41284881,92390912,5,0,1,15360,25,9582482133
9515,51129600,35079160,86208760,5,0,0,61952,25,6477172522
9516,51142610,34562053,85704663,6,0,0,20992,17,5861755178
9517,51170650,35104175,86274825,5,0,0,58880,25,6296497737
9518,51171760,41236732,92408492,4,0,1,4608,25,3484645816
9519,51174670,41235768,92410438,4,0,1,3072,25,4236572375
9520,51186460,41224644,92411104,4,0,1,1024,25,9316437601
9521,51187730,34523695,85711425,0,0,0,21504,8,7065740277
9522,51195670,34751900,85947570,5,0,0,11776,25,9725010125
9523,51196470,41215326,92411796,4,0,1,1024,25,16349503
9524,51205931,35252373,86458304,9,0,0,35840,4,4093457740
9525,51209211,41203251,92412462,5,0,1,1024,25,8554317403
9526,51214990,34662963,85877953,9,0,0,22016,4,8191175760
9527,51223160,41190288,92413448,4,0,1,1536,25,4830206190
9528,51232390,35367413,86599803,5,0,0,69632,25,1954094781
9529,51239270,34805463,86044733,6,0,0,71680,17,4792287712
9530,51244171,34650925,85895096,9,0,0,23552,4,9922722229
9531,51247671,41171883,92419554,5,0,1,20992,25,10062610767
9532,51256761,41169215,92425976,5,0,1,6144,25,463374302
9533,51257010,35120119,86377129,6,0,0,52736,17,10115998193
9534,51270009,35051524,86321533,4,0,0,21504,25,5855383604
9535,51277991,34935472,86213463,9,0,0,15360,4,364331859
9536,51286240,41141362,92427602,4,0,1,2560,25,7814756487
9537,51286771,35230379,86517150,9,0,0,28672,4,10231536847
9538,51287650,35473175,86760825,0,0,0,108544,8,6876299742
9539,51289810,41144079,92433889,4,0,1,1024,25,502098606
9540,51313700,35133661,86447361,5,0,0,69632,25,5318343556
9541,51333110,35244495,86577605,6,0,0,125440,17,4388291934
9542,51343749,35308217,86651966,4,0,0,102400,25,7391753273
9543,51360181,35296028,86656209,9,0,0,13824,4,7652850337
9544,51374639,34755181,86129820,4,0,0,2048,25,2358958087
9545,51385980,35467324,86853304,5,0,0,7168,25,9831634671
9546,51402390,35118121,86520511,6,0,0,3072,17,10593373400
9547,51422130,35097422,86519552,5,0,0,4096,25,5158030528
9548,51427880,35361227,86789107,5,0,0,91648,25,10295592103
9549,51432400,34878629,86311029,5,0,0,10752,25,5033811863
9550,51456040,34935324,86391364,5,0,0,22528,25,5077857929
9551,51456219,40979616,92435835,6,0,1,3072,17,3153469484
9552,51470951,35037394,86508345,9,0,0,103424,4,8111951247
9553,51471919,40974487,92446406,6,0,1,2560,17,9178927022
9554,51473460,35502900,86976360,6,0,0,131072,17,7511523544
9555,51474360,34822142,86296502,6,0,0,32256,17,9542645974
9556,51478440,40993424,92471864,9,0,1,15872,4,10053738159
9557,51479670,41002837,92482507,9,0,1,16384,4,9106551665
9558,51482020,35036245,86518265,5,0,0,3584,25,3159274080
9559,51489860,40993953,92483813,9,0,1,2048,4,5113548043
9560,51494189,35421478,86915667,4,0,0,62976,25,113108856
9561,51500251,35382958,86883209,9,0,0,13312,4,4585561530
9562,51501000,40987639,92488639,9,0,1,7680,4,6979067032
9563,51501980,35613294,87115274,6,0,0,204288,17,8450273448
9564,51503590,35930981,87434571,6,0,0,206336,17,4476917960
9565,51505820,40984708,92490528,9,0,1,2048,4,8255002186
9566,51506050,35639222,87145272,5,0,0,25600,25,8286044098
9567,51506729,35071835,86578564,4,0,0,3072,25,289695807
9568,51509219,35111524,86620743,4,0,0,22528,25,7773826045
9569,51516411,35967796,87484207,9,0,0,125440,4,1358902127
9570,51517859,40975255,92493114,6,0,1,4096,17,6676259030
9571,51518470,40978830,92497300,0,0,1,6656,8,5353097155
9572,51531889,36093037,87624926,4,0,0,27136,25,5856079288
9573,51539230,40958326,92497556,4,0,1,9216,25,1469594119
9574,51552590,35887221,87439811,6,0,0,3584,17,9243749091
9575,51558730,35202430,86761160,6,0,0,1024,17,2673440867
9576,51563130,35253172,86816302,6,0,0,17920,17,5606184669
9577,51567200,40932302,92499502,4,0,1,3072,25,9886406754
9578,51568610,35222236,86790846,5,0,0,5632,25,2237584066
9579,51573249,35666905,87240154,4,0,0,3072,25,1004972022
9580,51575279,40927449,92502728,6,0,1,5120,17,1822059205
9581,51588680,40914714,92503394,6,0,1,1024,17,6795199118
9582,51589879,35547570,87137449,4,0,0,72704,25,6514012265
9583,51595300,40910680,92505980,6,0,1,4096,17,8979349595
9584,51611719,40895887,92507606,6,0,1,2560,17,2372935401
9585,51616940,35262190,86879130,6,0,0,18432,17,7117246544
9586,51626260,40882012,92508272,4,0,1,1024,25,1924446342
9587,51636189,35073537,86709726,4,0,0,4096,25,4701343347
9588,51636590,40875228,92511818,4,0,1,5632,25,8494883268
9589,51646060,35290341,86936401,5,0,0,42496,25,9258440743
9590,51649190,35170426,86819616,5,0,0,10752,25,8537848183
9591,51664660,40848464,92513124,6,0,1,2048,17,10348834555
9592,51667160,35310939,86978099,6,0,0,5632,17,5345962682
9593,51668330,35703350,87371680,6,0,0,161792,17,7432533891
9594,51677280,40836190,92513470,4,0,1,512,25,6740889268
9595,51698990,40815146,92514136,6,0,1,1024,17,2257244309
9596,51699730,35576235,87275965,6,0,0,13824,17,5851718401
9597,51714180,40808674,92522854,4,0,1,23040,25,4832386427
9598,51723330,40799678,92523008,4,0,1,8704,25,7897373729
9599,51729050,40794304,92523354,4,0,1,512,25,10146874679
9600,51734059,35496665,87230724,4,0,0,19456,25,630221140
9601,51737570,35247242,86984812,5,0,0,7680,25,10734556997
9602,51771429,35496994,87268423,4,0,0,47616,25,1862196048
9603,51777730,40746610,92524340,6,0,1,1536,17,1998492643
9604,51778209,35740871,87519080,4,0,0,114176,25,9166766283
9605,51784439,40740567,92525006,6,0,1,11264,17,2790677352
9606,51792769,40756539,92549308,8,0,1,3072,1,8688623841
9607,51794850,35476872,87271722,6,0,0,10752,17,6546004946
9608,51816479,35437413,87253892,4,0,0,26624,25,1404997714
9609,51867559,35437851,87305410,4,0,0,22016,25,500915639
9610,51882029,35556667,87438696,4,0,0,2048,25,4959985044
9611,51899670,35309634,87209304,6,0,0,14336,17,5168780601
9612,51912510,35626740,87539250,6,0,0,51200,17,2083931845
9613,51917949,35520100,87438049,4,0,0,11264,25,9842636416
9614,51927160,35678064,87605224,5,0,0,55808,25,4907420470
9615,51942130,35257310,87199440,5,0,0,7168,25,1307060264
9616,51958190,35658445,87616635,5,0,0,37376,25,4625078461
9617,51978209,35648456,87626665,4,0,0,5632,25,6160956180
9618,51999760,35446181,87445941,6,0,0,19968,17,3931414348
9619,52037610,35900010,87937620,5,0,0,11264,25,4237271470
9620,52038359,36198903,88237262,4,0,0,126976,25,9601381654
9621,52056110,35632687,87688797,6,0,0,21504,17,8593125662
9622,52060789,35840833,87901622,4,0,0,51712,25,7984004300
9623,52066809,35456818,87523627,4,0,0,14848,25,9631475968
9624,52067250,35648581,87715831,5,0,0,26624,25,9934731991
9625,52068660,35488988,87557648,6,0,0,59904,17,10670495531
9626,52086139,40463515,92549654,6,0,1,512,17,2091762248
9627,52107090,36055317,88162407,6,0,0,143872,17,5015170789
9628,52114070,35956299,88070369,6,0,0,171520,17,3033202546
9629,52115090,35580438,87695528,6,0,0,1536,17,3309500640
9630,52132909,35437046,87569955,4,0,0,5632,25,2397652307
9631,52137149,40415411,92552560,6,0,1,4608,17,1302157555
9632,52154249,40400897,92555146,6,0,1,4096,17,8221692974
9633,52158209,36018307,88176516,4,0,0,1024,25,409262512
9634,52167959,36009882,88177841,4,0,0,4096,25,10511869812
9635,52174120,35843966,88018086,5,0,0,32256,25,3805337473
9636,52185560,36129750,88315310,6,0,0,83456,17,3659246251
9637,52212249,35578336,87790585,4,0,0,8704,25,10481987332
9638,52218330,35957851,88176181,5,0,0,2560,25,4835951281
9639,52250449,36264908,88515357,4,0,0,161280,25,5728631710
9640,52264519,35926792,88191311,4,0,0,17920,25,7222788115
9641,52266459,35850421,88116880,4,0,0,152576,25,3699791113
9642,52281900,36090414,88372314,6,0,0,98816,17,4897919511
9643,52306699,40254348,92561047,8,0,1,19968,1,4827511567
9644,52334660,35932179,88266839,5,0,0,70144,25,1948084132
9645,52339190,36112548,88451738,5,0,0,32256,25,3999689559
9646,52344259,40217044,92561303,8,0,1,9216,1,3011444599
9647,52358289,40205600,92563889,6,0,1,4096,17,514452208
9648,52360770,35884666,88245436,6,0,0,26624,17,10011977133
9649,52361679,35824141,88185820,4,0,0,26112,25,4633543845
9650,52388570,40177265,92565835,4,0,1,3072,25,2480245208
9651,52390640,35606342,87996982,5,0,0,17408,25,8970936192
9652,52392449,36374416,88766865,4,0,0,127488,25,2984246835
9653,52397270,36273394,88670664,5,0,0,25088,25,8693178921
9654,52402970,35715570,88118540,5,0,0,5120,25,4884397577
9655,52407709,40159432,92567141,8,0,1,2048,1,1440428172
9656,52411989,40158058,92570047,8,0,1,4608,1,9637710701
9657,52413910,35306218,87720128,6,0,0,6656,17,832203507
9658,52419469,40151244,92570713,8,0,1,1024,1,3992601109
9659,52423590,36212889,88636479,5,0,0,73728,25,5154544599
9660,52424800,35857350,88282150,5,0,0,50176,25,6964600349
9661,52425929,40145130,92571059,8,0,1,512,1,3745778194
9662,52442669,35732709,88175378,4,0,0,42496,25,3808292170
9663,52443850,40127555,92571405,0,0,1,512,8,3282698296
9664,52444560,40128164,92572724,4,0,1,13312,25,4559621477
9665,52452419,40120651,92573070,8,0,1,512,1,3372531103
9666,52452509,36124509,88577018,4,0,0,39936,25,4251398964
9667,52475100,40101196,92576296,4,0,1,5120,25,10726549131
9668,52475879,40111979,92587858,8,0,1,12800,1,1531487443
9669,52477709,40112735,92590444,8,0,1,4096,1,4995329668
9670,52483020,40108090,92591110,0,0,1,1024,8,4583408968
9671,52483220,40108454,92591674,0,0,1,10752,8,671002309
9672,52491179,35700491,88191670,4,0,0,1024,25,4921312847
9673,52512919,40103372,92616291,8,0,1,4608,1,6569241982
9674,52524000,36299489,88823489,6,0,0,99840,17,7277970141
9675,52525089,36021262,88546351,4,0,0,32256,25,131661950
9676,52525130,40101440,92626570,4,0,1,2560,25,3131002287
9677,52538549,40088367,92626916,8,0,1,512,1,5940710121
9678,52540999,36249215,88790214,4,0,0,28160,25,729464376
9679,52543160,35993332,88536492,5,0,0,39424,25,6800674488
9680,52548000,40086328,92634328,4,0,1,11776,25,8906824562
9681,52556040,36157222,88713262,5,0,0,29184,25,7812799336
9682,52565529,40069465,92634994,8,0,1,1024,1,9694124191
9683,52573160,35991667,88564827,6,0,0,31232,17,7961216149
9684,52580699,40056241,92636940,8,0,1,3072,1,2082534754
9685,52591130,40048076,92639206,4,0,1,3584,25,8708707834
9686,52592629,40049803,92642432,8,0,1,5120,1,1030446527
9687,52594980,36181906,88776886,5,0,0,27648,25,9913001336
9688,52600290,36122823,88723113,6,0,0,32256,17,8821824176
9689,52604609,36388984,88993593,4,0,0,89088,25,8262395114
9690,52619850,40030101,92649951,4,0,1,6144,25,5946600469
9691,52620630,36083717,88704347,6,0,0,52736,17,5989811544
9692,52623389,40031068,92654457,8,0,1,7168,1,5521189593
9693,52641570,40019787,92661357,4,0,1,20480,25,4242779866
9694,52641999,36254610,88896609,4,0,0,43008,25,2634791008
9695,52660400,35983902,88644302,5,0,0,25600,25,8682193177
9696,52683039,39981224,92664263,8,0,1,4608,1,3442916106
9697,52684380,39983429,92667809,4,0,1,5632,25,1924936209
9698,52693090,36446981,89140071,5,0,0,55296,25,5283558033
9699,52701079,36158451,88859530,4,0,0,45056,25,3887731418
9700,52733090,35868771,88601861,5,0,0,19968,25,6399129010
9701,52735800,39961251,92697051,4,0,1,3072,25,2219643074
9702,52740390,39958927,92699317,4,0,1,3584,25,9738383102
9703,52741909,36206827,88948736,4,0,0,66560,25,2507442861
9704,52765800,39937063,92702863,4,0,1,5632,25,4090465161
9705,52778060,35909781,88687841,5,0,0,13824,25,3555144728
9706,52784480,36309238,89093718,5,0,0,79872,25,10390345522
9707,52786109,39917740,92703849,6,0,1,1536,17,4241790575
9708,52805479,36197699,89003178,4,0,0,31232,25,3072303070
9709,52809779,35958628,88768407,4,0,0,4608,25,8128531118
9710,52810549,39895067,92705616,6,0,1,12288,17,4798357738
9711,52810990,36143252,88954242,6,0,0,9728,17,1666118980
9712,52866830,36061603,88928433,6,0,0,16384,17,1837340794
9713,52874879,39831710,92706589,6,0,1,12800,17,65949924
9714,52936519,39783176,92719695,6,0,1,6656,17,3964025159
9715,52951810,39769831,92721641,0,0,1,3072,8,10652273279
9716,52957200,35694555,88651755,6,0,0,23040,17,1295159239
9717,52957780,36162573,89120353,5,0,0,60928,25,3131401880
9718,52963579,39760648,92724227,6,0,1,4096,17,4045886840
9719,52996010,36429550,89425560,5,0,0,75264,25,4123848636
9720,53011609,39714884,92726493,6,0,1,3584,17,3101130436
9721,53033590,39694849,92728439,0,0,1,3072,8,7875032323
9722,53033679,39697986,92731665,6,0,1,5120,17,6433623023
9723,53055400,35772012,88827412,5,0,0,12800,25,5488661775
9724,53056670,35620219,88676889,5,0,0,3584,25,5183483636
9725,53069060,39666791,92735851,0,0,1,6656,8,9074693466
9726,53072909,39664914,92737823,6,0,1,3072,17,1612949854
9727,53120460,39617709,92738169,0,0,1,512,8,7413495243
9728,53121890,36397804,89519694,6,0,0,30208,17,2307053246
9729,53122310,35916472,89038782,5,0,0,7680,25,5991357232
9730,53130820,39608335,92739155,0,0,1,1536,8,2839353658
9731,53158870,35849502,89008372,6,0,0,16896,17,395592029
9732,53159881,39582180,92742061,5,0,1,4608,25,10273711484
9733,53162951,39579456,92742407,5,0,1,512,25,7461765054
9734,53174721,39568672,92743393,5,0,1,1536,25,2704862151
9735,53201860,39543799,92745659,0,0,1,3584,8,7644136302
9736,53220730,39528065,92748795,0,0,1,3072,8,7729662349
9737,53224100,39525361,92749461,0,0,1,1024,8,2965622690
9738,53233301,39516826,92750127,5,0,1,1024,25,9961409241
9739,53235281,39521618,92756899,5,0,1,10752,25,8888794417
9740,53253239,39508806,92762045,6,0,1,20480,17,3213230387
9741,53256611,39525961,92782572,5,0,1,512,25,7621475827
9742,53260181,39523057,92783238,5,0,1,1024,25,7669834067
9743,53271930,39512281,92784211,0,0,1,12800,8,7254237273
9744,53280741,39504776,92785517,5,0,1,2048,25,2336782434
9745,53288350,35813370,89101720,6,0,0,26112,17,3243209854
9746,53296390,35758540,89054930,6,0,0,44544,17,1443991170
9747,53324110,39480696,92804806,0,0,1,18432,8,67711432
9748,53327140,39479932,92807072,0,0,1,3584,8,3107756983
9749,53352171,39457807,92809978,5,0,1,4608,25,8336853788
9750,53358801,39459708,92818509,5,0,1,3584,25,8244687402
9751,53372500,35915225,89287725,6,0,0,1536,17,9178278805
9752,53388460,35734724,89123184,6,0,0,9216,17,10503536588
9753,53405560,39413308,92818868,0,0,1,9728,8,1946840290
9754,53432880,39391480,92824360,0,0,1,8704,8,5837677491
9755,53446430,39382436,92828866,0,0,1,7168,8,7171353718
9756,53459060,39371432,92830492,0,0,1,2560,8,5586062120
9757,53488910,35773597,89262507,6,0,0,97280,17,5861716492
9758,53489470,39352640,92842110,0,0,1,10752,8,4301186741
9759,53501220,35845411,89346631,6,0,0,70656,17,10101241675
9760,53504541,39344123,92848664,5,0,1,5120,25,8931374998
9761,53504750,36161860,89666610,6,0,0,24064,17,7171911108
9762,53545711,39305565,92851276,5,0,1,4096,25,4335885688
9763,53553440,39300908,92854348,0,0,1,3072,8,1902872657
9764,53570220,35584143,89154363,6,0,0,16896,17,6923905086
9765,53582141,39275151,92857292,5,0,1,10752,25,3905738886
9766,53587931,39280926,92868857,5,0,1,2048,25,8088437915
9767,53589420,35553840,89143260,6,0,0,6656,17,1848293980
9768,53601351,39270082,92871433,5,0,1,8704,25,1989675777
9769,53609910,35849837,89459747,6,0,0,112128,17,8636902486
9770,53614881,39260418,92875299,5,0,1,6144,25,457539793
9771,53619060,36028433,89647493,6,0,0,16896,17,7570721641
9772,53619739,39257186,92876925,8,0,1,2560,1,705555935
9773,53625761,39256889,92882650,5,0,1,2048,25,4863689730
9774,53641040,35950356,89591396,6,0,0,65536,17,5874277353
9775,53642891,39241065,92883956,5,0,1,2048,25,9848652019
9776,53658410,35688712,89347122,6,0,0,1536,17,7991325585
9777,53670701,39242206,92912907,5,0,1,15360,25,6550815499
9778,53687051,39250868,92937919,5,0,1,5120,25,4042722680
9779,53689711,39248874,92938585,5,0,1,1024,25,1008774433
9780,53706861,39232390,92939251,5,0,1,1024,25,7768475082
9781,53708310,39231287,92939597,0,0,1,512,8,585413945
9782,53740970,39199613,92940583,0,0,1,1536,8,4012010021
9783,53741421,39214429,92955850,5,0,1,18432,25,2374372445
9784,53748529,39219801,92968330,6,0,1,2560,17,3439074652
9785,53763670,35518976,89282646,6,0,0,20480,17,2898656769
9786,53781251,39188065,92969316,5,0,1,1536,25,813616843
9787,53795190,35971667,89766857,6,0,0,51712,17,5315414581
9788,53814891,39170546,92985437,5,0,1,8704,25,4630405075
9789,53914270,35299520,89213790,6,0,0,5120,17,10592778802
9790,53980180,35770898,89751078,6,0,0,126976,17,729889181
9791,54036960,35030826,89067786,6,0,0,2048,17,1388505170
9792,54045991,38941072,92987063,5,0,1,2560,25,5297224561
9793,54046681,38940728,92987409,5,0,1,512,25,5318739176
9794,54052071,38936324,92988395,5,0,1,1536,25,991623221
9795,54069781,38921840,92991621,5,0,1,5120,25,3513562511
9796,54120900,35797856,89918756,6,0,0,43008,17,1515191465
9797,54126870,35725614,89852484,5,0,0,60416,25,8061385176
9798,54140251,38852996,92993247,5,0,1,2560,25,6204792736
9799,54148350,35679469,89827819,6,0,0,48640,17,7511975768
9800,54158451,38838048,92996499,5,0,1,5120,25,8390434550
9801,54165680,35295525,89461205,5,0,0,4608,25,6343919605
9802,54189920,35469296,89659216,6,0,0,38400,17,10676978979
9803,54191100,35778554,89969654,5,0,0,122368,25,8264843277
9804,54227020,35304291,89531311,5,0,0,1024,25,9772294400
9805,54228451,38772554,93001005,5,0,1,7168,25,4079330645
9806,54230180,35456640,89686820,6,0,0,34304,17,9844416619
9807,54264081,38737270,93001351,5,0,1,512,25,4322603433
9808,54273431,38728266,93001697,5,0,1,512,25,1741810203
9809,54302101,38702848,93004949,5,0,1,5120,25,9136704923
9810,54320831,38685104,93005935,5,0,1,1536,25,3585700657
9811,54327070,35485906,89812976,5,0,0,34304,25,980522642
9812,54352550,34950754,89303304,5,0,0,8192,25,3442648103
9813,54379501,38627740,93007241,5,0,1,2048,25,6346136695
9814,54387400,35254922,89642322,6,0,0,92672,17,2613463100
9815,54415829,38591758,93007587,6,0,1,512,17,5629274081
9816,54420891,38591522,93012413,5,0,1,7680,25,7143675818
9817,54423480,35887327,90310807,6,0,0,62976,17,6966631342
9818,54424300,35125352,89549652,6,0,0,3072,17,4485345403
9819,54426979,38589646,93016625,8,0,1,6656,1,6934049719
9820,54441180,38577071,93018251,0,0,1,2560,8,1911969887
9821,54441291,38578906,93020197,5,0,1,3072,25,3385255285
9822,54442249,38581174,93023423,6,0,1,5120,17,5887335843
9823,54453520,35152130,89605650,5,0,0,6144,25,396479342
9824,54467680,35610533,90078213,6,0,0,115712,17,2462063817
9825,54477980,35533692,90011672,5,0,0,47104,25,7781573567
9826,54478130,35093275,89571405,6,0,0,25600,17,3589729828
9827,54488309,38538660,93026969,6,0,1,5632,17,9099868388
9828,54490929,38539382,93030311,6,0,1,16896,17,9763403317
9829,54497639,38537521,93035160,8,0,1,6144,1,7248030562
9830,54506290,35738400,90244690,5,0,0,73728,25,8740934706
9831,54513419,38525287,93038706,8,0,1,5632,1,2994637548
9832,54519769,38519603,93039372,6,0,1,1024,17,4538790341
9833,54521521,38525216,93046737,5,0,1,7680,25,9733980399
9834,54528050,38519148,93047198,0,0,1,10240,8,3679512338
9835,54534481,38513383,93047864,5,0,1,1024,25,4968381479
9836,54539300,38527053,93066353,0,0,1,16384,8,5681726835
9837,54550809,38529511,93080320,6,0,1,512,17,2469482680
9838,54554150,38529046,93083196,0,0,1,1536,8,1267752658
9839,54557270,35243004,89800274,5,0,0,23552,25,3848323341
9840,54577399,38506775,93084174,6,0,1,512,17,963792429
9841,54581800,38503040,93084840,6,0,1,1024,17,8034503961
9842,54586740,38521067,93107807,6,0,1,29184,17,3822519709
9843,54587159,38535264,93122423,6,0,1,4608,17,286047081
9844,54593641,38532328,93125969,5,0,1,5632,25,2228956305
9845,54599599,38530236,93129835,6,0,1,6144,17,918366566
9846,54601131,38537827,93138958,5,0,1,3584,25,2737683660
9847,54625380,35513366,90138746,6,0,0,4608,17,3103468681
9848,54638000,35404934,90042934,5,0,0,77824,25,9416498601
9849,54645660,38494604,93140264,6,0,1,2048,17,8240814508
9850,54646010,38494920,93140930,0,0,1,1024,8,3122855739
9851,54646399,38495197,93141596,6,0,1,1024,17,10182373088
9852,54654650,35342639,89997289,5,0,0,90624,25,6142250482
9853,54680250,38465852,93146102,0,0,1,7168,8,4459211600
9854,54691941,38471411,93163352,5,0,1,19968,25,5072310840
9855,54702970,35393081,90096051,6,0,0,44032,17,5434278314
9856,54709380,38455918,93165298,0,0,1,3072,8,4652420885
9857,54713530,38452114,93165644,0,0,1,512,8,8041072315
9858,54713810,35217558,89931368,6,0,0,13824,17,839509426
9859,54720040,35299143,90019183,5,0,0,24576,25,10248750085
9860,54739110,38427520,93166630,0,0,1,1536,8,1869407201
9861,54746470,35363534,90110004,6,0,0,26624,17,988921375
9862,54751551,38415425,93166976,5,0,1,512,25,9693739021
9863,54765791,38401851,93167642,5,0,1,1024,25,2396965629
9864,54782290,35319579,90101869,5,0,0,16896,25,4674052445
9865,54782801,38388067,93170868,5,0,1,5120,25,6671479749
9866,54791340,35305358,90096698,6,0,0,2048,17,9625199081
9867,54804910,35417293,90222203,6,0,0,105472,17,10356058625
9868,54826900,35255704,90082604,6,0,0,14336,17,3689979400
9869,54860241,38312253,93172494,5,0,1,2560,25,8689928788
9870,54883671,38289489,93173160,5,0,1,1024,25,5653182700
9871,54888040,35389073,90277113,5,0,0,51712,25,10193903171
9872,54933510,35319835,90253345,5,0,0,1024,25,8151013322
9873,54939750,35246109,90185859,5,0,0,6144,25,1291003356
9874,54945331,38228495,93173826,5,0,1,1024,25,6156080083
9875,54947030,35499715,90446745,5,0,0,52736,25,8559030119
9876,54949481,38224499,93173980,5,0,1,8704,25,81741730
9877,54951201,38231328,93182529,5,0,1,512,25,6096883285
9878,54958920,38225875,93184795,6,0,1,3584,17,9091197600
9879,54962551,38222500,93185051,5,0,1,9216,25,8300643971
9880,54967230,35659860,90627090,5,0,0,35840,25,8215020425
9881,54977220,38209247,93186467,6,0,1,2048,17,3029648701
9882,54987651,38202434,93190085,5,0,1,4608,25,7177319554
9883,55027620,38164660,93192280,6,0,1,1536,17,2059000484
9884,55033420,35784531,90817951,6,0,0,5120,17,530397312
9885,55034620,35327943,90362563,5,0,0,13824,25,10245696556
9886,55050340,35860996,90911336,5,0,0,104960,25,10641290558
9887,55059061,38133565,93192626,5,0,1,512,25,9290322631
9888,55087461,38107111,93194572,5,0,1,3072,25,3403438211
9889,55091670,38127308,93218978,6,0,1,2048,17,8664143099
9890,55103110,35586897,90690007,6,0,0,2048,17,5531646136
9891,55107020,38116144,93223164,6,0,1,6656,17,9846689216
9892,55112861,38110649,93223510,5,0,1,512,25,5682214626
9893,55126330,38101686,93228016,6,0,1,7168,17,2390723919
9894,55131990,35896934,91028924,6,0,0,89088,17,1402156167
9895,55134770,35481377,90616147,5,0,0,81920,25,3752639994
9896,55139890,38096664,93236554,6,0,1,16384,17,4051894477
9897,55165671,38074109,93239780,5,0,1,5120,25,1966266954
9898,55167790,35313754,90481544,5,0,0,7680,25,3926551210
9899,55170170,35413526,90583696,5,0,0,19968,25,8784841421
9900,55171989,38068137,93240126,8,0,1,512,1,5913445873
9901,55196140,35610845,90806985,5,0,0,131584,25,6573750756
9902,55212991,38027801,93240792,5,0,1,1024,25,9423204158
9903,55217791,38023987,93241778,5,0,1,1536,25,1842238528
9904,55227520,35472743,90700263,5,0,0,14336,25,9188861836
9905,55245641,37998040,93243681,5,0,1,1536,25,7518067064
9906,55263791,37981535,93245326,5,0,1,9728,25,5524275677
9907,55268781,37990261,93259042,5,0,1,1536,25,8876442728
9908,55290381,37969122,93259503,5,0,1,10240,25,1871884960
9909,55297500,35518868,90816368,5,0,0,30720,25,10690183367
9910,55338901,37921588,93260489,5,0,1,1536,25,10684284992
9911,55345150,35492542,90837692,5,0,0,7680,25,8173753211
9912,55359211,37902584,93261795,5,0,1,2048,25,6495550515
9913,55363301,37902680,93265981,5,0,1,6656,25,6737292555
9914,55363920,35463258,90827178,5,0,0,30208,25,1973131526
9915,55374141,37920457,93294598,5,0,1,14848,25,8535438228
9916,55394111,37928001,93322112,5,0,1,11264,25,4224543690
9917,55411601,37911177,93322778,5,0,1,11264,25,2632084004
9918,55425051,37899353,93324404,5,0,1,2560,25,1551266382
9919,55431621,37893811,93325432,5,0,1,512,25,4003335299
9920,55493160,35342153,90835313,5,0,0,26624,25,8875757980
9921,55553830,35428685,90982515,5,0,0,76800,25,5300012488
9922,55554420,35310299,90864719,5,0,0,57856,25,6301816529
9923,55564280,35191193,90755473,5,0,0,44032,25,10676389626
9924,55587200,35340457,90927657,5,0,0,6144,25,4740488839
9925,55606730,35603168,91209898,5,0,0,27136,25,9767058822
9926,55647780,35088229,90736009,5,0,0,86016,25,7485341711
9927,55655029,37674909,93329938,8,0,1,7168,1,246766593
9928,55667139,37663465,93330604,8,0,1,11264,1,406713275
9929,55681889,37662728,93344617,8,0,1,2048,1,7245764506
9930,55688109,37662640,93350749,8,0,1,9728,1,3293534907
9931,55694340,37659635,93353975,0,0,1,5120,8,5493343654
9932,55705020,35283290,90988310,5,0,0,18944,25,8502509608
9933,55723439,37635708,93359147,8,0,1,8192,1,2363512852
9934,55724090,35314959,91039049,5,0,0,15360,25,1320157292
9935,55754260,37605873,93360133,0,0,1,1536,8,1073904327
9936,55791549,37570210,93361759,8,0,1,2560,1,7181999440
9937,55806259,37555846,93362105,8,0,1,512,1,7966905364
9938,55818079,37544692,93362771,8,0,1,1024,1,2716650541
9939,55823020,37540417,93363437,0,0,1,1024,8,1981948405
9940,55868769,37495974,93364743,8,0,1,2048,1,2327529653
9941,55880060,35121689,91001749,5,0,0,44032,25,9641395553
9942,55898819,37471070,93369889,8,0,1,8192,1,8995779711
9943,55899869,37472926,93372795,8,0,1,4608,1,6725442399
9944,55901930,35199531,91101461,5,0,0,58880,25,7682085943
9945,55919069,37454392,93373461,8,0,1,1024,1,1012717767
9946,55931880,34941727,90873607,5,0,0,10240,25,333724002
9947,55947949,37425666,93373615,8,0,1,8704,1,4730943949
9948,55961550,34953865,90915415,5,0,0,13312,25,8936426097
9949,55966469,37407492,93373961,8,0,1,512,1,8494755992
9950,55970999,37405228,93376227,8,0,1,3584,1,3121673602
9951,55971999,37408414,93380413,8,0,1,6656,1,4488325514
9952,55972440,35087700,91060140,5,0,0,50176,25,10531316424
9953,55973970,35161963,91135933,5,0,0,7168,25,5410702265
9954,56031059,37355027,93386086,8,0,1,8192,1,6457004825
9955,56112699,37275333,93388032,8,0,1,3072,1,5393037256
9956,56118829,37270509,93389338,8,0,1,2048,1,7365130958
9957,56144350,34917529,91061879,5,0,0,5632,25,6138271473
9958,56145099,37244585,93389684,8,0,1,512,1,916709106
9959,56291779,37102757,93394536,8,0,1,7680,1,10308951789
9960,56420689,36974513,93395202,8,0,1,1024,1,8498051769
9961,56427989,36970119,93398108,8,0,1,4608,1,4311818484
9962,56468169,36936962,93405131,8,0,1,4096,1,8258823627
9963,56473099,36933683,93406782,8,0,1,1536,1,8410461969
9964,56578829,36829899,93408728,8,0,1,3072,1,7351810010
9965,56607439,36806695,93414134,8,0,1,8192,1,2124931268
9966,56646599,36769182,93415781,8,0,1,512,1,2503096164
9967,56652939,36766708,93419647,8,0,1,6144,1,7002472459
9968,56697669,36749894,93447563,8,0,1,7680,1,2927588998
9969,56729589,36731682,93461271,8,0,1,1024,1,7899143539
9970,56759309,36704228,93463537,8,0,1,3584,1,6373986872
9971,56800149,36664054,93464203,8,0,1,1024,1,3043987542
9972,56854259,36611250,93465509,8,0,1,2048,1,7040377410
9973,56860820,34240820,91101640,8,0,0,512,1,4112817456
9974,56876489,36598656,93475145,8,0,1,6656,1,4438270478
9975,56897829,36577572,93475401,8,0,1,9216,1,8645834079
9976,56939399,36537308,93476707,8,0,1,2048,1,3175186882
9977,56943219,36535025,93478244,8,0,1,13312,1,6008425221
9978,56946279,36532119,93478398,8,0,1,8704,1,6182475946
9979,56952109,36545598,93497707,8,0,1,2048,1,10646772947
9980,56964369,36540589,93504958,8,0,1,19456,1,3454456496
9981,56995109,36512115,93507224,8,0,1,3584,1,937237075
9982,57024659,36506881,93531540,8,0,1,9728,1,7322058093
9983,57047689,36485157,93532846,8,0,1,2048,1,9413768904
9984,57051619,36490722,93542341,8,0,1,12800,1,2096549842
9985,57070299,36479719,93550018,8,0,1,3072,1,9838804485
9986,57071409,36478763,93550172,8,0,1,8704,1,3262883492
9987,57124119,36444591,93568710,8,0,1,5120,1,2035207483
9988,57158239,36412417,93570656,8,0,1,3072,1,545825654
9989,57186170,34207294,91393464,8,0,0,512,1,3442663900
9990,57212080,34367956,91580036,8,0,0,512,1,25123996
9991,57219490,34255474,91474964,8,0,0,512,1,6077713736
9992,57223019,36361111,93584130,8,0,1,11776,1,9864277612
9993,57226009,36358467,93584476,8,0,1,512,1,1192535963
9994,57229829,36354801,93584630,8,0,1,8704,1,6186668285
9995,57254399,36330692,93585091,8,0,1,10240,1,1320597958
9996,57284760,34166822,91451582,8,0,0,512,1,6355797324
9997,57345110,34083712,91428822,8,0,0,512,1,10566375738
9998,57379979,36210730,93590709,8,0,1,3584,1,2292049350
9999,57432240,34084117,91516357,8,0,0,512,1,5980696973
